一一	[jat1 jat1]one by one/one after another
一一對應	[jat1 jat1 deoi3 jing1]one-to-one correspondence
一一映射	[jat1 jat1 jing2 se6]bijective map (i.e. map between sets in math. that is one-to-one and onto)/one-to-one correspondence
一丁不識	[jat1 ding1 bat1 sik1]illiterate/ignorant
一丁點	[jat1 ding1 dim2]a tiny bit/a wee bit
一下	[jat1 haa6](used after a verb) give it a go/to do (sth for a bit to give it a try)/one time/once/in a while/all of a sudden/all at once
一下兒	[jat1 haa6 ji4]erhua variant of 一下[yi1 xia4]
一下子	[jat1 haa6 zi2]in a short while/all at once/all of a sudden
一世	[jat1 sai3]generation/period of 30 years/one's whole lifetime/lifelong/age/era/times/the whole world/the First (of numbered European kings)
一並	[jat1 bing6]variant of 一併|一并, to lump together/to treat along with all the others
一中一台	[jat1 zung1 jat1 toi4]one China and one Taiwan (policy)
一中原則	[jat1 zung1 jyun4 zak1]One-China principle, the official doctrine that Taiwan is a province of China
一串	[jat1 cyun3]strand
一之為甚	[jat1 zi1 wai4 sam6]Once is enough (idiom)
一之謂甚	[jat1 zi1 wai6 sam6]see 一之為甚|一之为甚[yi1 zhi1 wei2 shen4]
一乾二淨	[jat1 gon1 ji6 zing6]thoroughly (idiom)/completely/one and all/very clean
一了百了	[jat1 liu5 baak3 liu5]once the main problem is solved, all troubles are solved/death ends all one's troubles
一事無成	[jat1 si6 mou4 sing4]to have achieved nothing/to be a total failure/to get nowhere
一二八事變	[jat1 ji6 baat3 si6 bin3]Shanghai incident of 28th January 1932, Chinese uprising against Japanese quarters of Shanghai
一些	[jat1 se1]some/a few/a little
一介不取	[jat1 gaai3 bat1 ceoi2]to not even take a penny (as a bribe)
一代	[jat1 doi6]generation
一代不如一代	[jat1 doi6 bat1 jyu4 jat1 doi6]to be getting worse with each generation
一併	[jat1 bing3]to lump together/to treat along with all the others
一來	[jat1 loi4]on one hand,...
一來二去	[jat1 loi4 ji6 heoi3]gradually/little by little/in the course of time
一個中國政策	[jat1 go3 zung1 gwok3 zing3 caak3]one China policy
一個人	[jat1 go3 jan4]by oneself (without assistance)/alone (without company)
一個個	[jat1 go3 go3]each and every one
一個勁	[jat1 go3 ging6]continuously/persistently/incessantly
一個勁兒	[jat1 go3 ging6 ji4]erhua variant of 一個勁|一个劲[yi1 ge4 jin4]
一個巴掌拍不響	[jat1 go3 baa1 zoeng2 paak3 bat1 hoeng2]lit. one palm alone cannot clap (proverb)/fig. it takes two persons to start a dispute/it takes two to tango/it's difficult to achieve anything without support
一個幽靈在歐洲遊蕩	[jat1 go3 jau1 ling4 zoi6 au1 zau1 jau4 dong6]Ein Gespenst geht um in Europa./the opening sentence of Marx and Engels' "Communist Manifesto"
一個接一個	[jat1 go3 zip3 jat1 go3]one by one/one after another
一個樣	[jat1 go3 joeng6]same as 一樣|一样[yi1 yang4]/the same
一個蘿蔔一個坑	[jat1 go3 lo4 baak6 jat1 go3 haang1]lit. every turnip to its hole (idiom)/fig. each person has his own position/each to his own/horses for courses/every kettle has its lid
一側化	[jat1 zak1 faa3]lateralization
一價	[jat1 gaa3]monovalent (chemistry)
一元	[jat1 jyun4]single variable (math.)/univariate
一元論	[jat1 jyun4 leon6]monism, belief that the universe is made of a single substance
一元醇	[jat1 jyun4 seon4]methyl alcohol CH3OH
一共	[jat1 gung6]altogether
一再	[jat1 zoi3]repeatedly
一准	[jat1 zeon2]certainly/also written 一準|一准[yi1 zhun3]
一分一毫	[jat1 fan1 jat1 hou4]a tiny bit (idiom)/an iota
一分為二	[jat1 fan1 wai4 ji6]one divides into two/to be two-sided/there are two sides to everything/to see both sb's good points and shortcomings (idiom)
一分錢一分貨	[jat1 fan1 cin4 jat1 fan1 fo3]nothing for nothing/you get what you pay for
一分錢兩分貨	[jat1 fan1 cin4 loeng5 fan1 fo3]high quality at bargain price
一切	[jat1 cit3]everything/every/all
一切事物	[jat1 cit3 si6 mat6]everything
一切向錢看	[jat1 cit3 hoeng3 cin4 hon3]to put money above everything else
一切如舊	[jat1 cit3 jyu4 gau6]everything as before
一切就緒	[jat1 cit3 zau6 seoi5]everything in its place and ready (idiom)
一切險	[jat1 cit3 him2]all risks (insurance)
一刻千金	[jat1 hak1 cin1 gam1]time is gold/every minute counts
一則	[jat1 zak1]on the one hand
一動不動	[jat1 dung6 bat1 dung6]motionless
一勞永逸	[jat1 lou4 wing5 jat6]to get sth done once and for all
一匙	[jat1 ci4]spoonful
一千零一夜	[jat1 cin1 ling4 jat1 je6]The Book of One Thousand and One Nights
一半	[jat1 bun3]half
一半天	[jat1 bun3 tin1]in a day or two/soon
一卡通	[jat1 kaa1 tung1]Yikatong (Beijing public transport smart card)
一去不回	[jat1 heoi3 bat1 wui4]gone forever
一去不復返	[jat1 heoi3 bat1 fuk6 faan1]gone forever
一去無影蹤	[jat1 heoi3 mou4 jing2 zung1]gone without a trace
一反常態	[jat1 faan2 soeng4 taai3]complete change from the normal state (idiom); quite uncharacteristic/entirely outside the norm/out of character
一口	[jat1 hau2]readily/flatly (deny, admit and so on)/a mouthful/a bite
一口吃不成胖子	[jat1 hau2 hek3 bat1 sing4 bun6 zi2]lit. you cannot get fat with only one mouthful (proverb)/fig. learn to walk before you run
一口吃個胖子	[jat1 hau2 hek3 go3 bun6 zi2]lit. to want to get fat with only one mouthful (proverb)/fig. to try to achieve one's goal in the shortest time possible/to be impatient for success
一口氣兒	[jat1 hau2 hei3 ji4]erhua variant of 一口氣|一口气[yi1 kou3 qi4]
一古腦兒	[jat1 gu2 nou5 ji4]variant of 一股腦兒|一股脑儿[yi1 gu3 nao3 r5]
一句	[jat1 geoi3]a line of verse/a sentence
一句話	[jat1 geoi3 waa6]in a word/in short
一同	[jat1 tung4]along/together
一吐為快	[jat1 tou3 wai4 faai3]to get sth off one's chest
一向	[jat1 hoeng3]always (previously)/a period of time in the recent past
一周	[jat1 zau1]one week/all the way around/a whole cycle
一味	[jat1 mei6]blindly/invariably
一呼百應	[jat1 fu1 baak3 jing1]a hundred answers to a single call (idiom)/to respond en masse
一呼百諾	[jat1 fu1 baak3 nok6]one command brings a hundred responses (idiom); having hundreds of attendants at one's beck and call
一命嗚呼	[jat1 ming6 wu1 fu1]to die (idiom)/to breathe one's last/to give up the ghost
一命歸天	[jat1 ming6 gwai1 tin1]see 一命嗚呼|一命呜呼[yi1 ming4 wu1 hu1]
一命歸西	[jat1 ming6 gwai1 sai1]see 一命嗚呼|一命呜呼[yi1 ming4 wu1 hu1]
一命歸陰	[jat1 ming6 gwai1 jam1]see 一命嗚呼|一命呜呼[yi1 ming4 wu1 hu1]
一品	[jat1 ban2]superb/first-rate/(of officials in imperial times) the highest rank
一品紅	[jat1 ban2 hung4]poinsettia (Euphorbia pulcherrima)
一品鍋	[jat1 ban2 wo1]chafing dish
一哄而散	[jat1 hung3 ji4 saan3]to disperse in confusion (idiom)
一哄而起	[jat1 hung3 ji4 hei2](of a group of people) to rush into action
一哭二鬧三上吊	[jat1 huk1 ji6 naau6 saam1 soeng6 diu3]to make a terrible scene (idiom)/to throw a tantrum
一唱一和	[jat1 coeng3 jat1 wo4]to echo one another (idiom)
一問三不知	[jat1 man6 saam1 bat1 zi1]lit. to reply "don't know" whatever the question (idiom)/fig. absolutely no idea of what's going on/complete ignorance
一回事	[jat1 wui4 si6]one thing/the same as
一團和氣	[jat1 tyun4 wo4 hei3]to keep on the right side of everyone (idiom)/warm and affable
一團漆黑	[jat1 tyun4 cat1 hak1]pitch-black/(fig.) to be completely in the dark
一團火	[jat1 tyun4 fo2]fireball/ball of fire
一團糟	[jat1 tyun4 zou1]chaos/bungle/complete mess/shambles
一堆	[jat1 deoi1]pile
一場空	[jat1 coeng4 hung1]all one's hopes and efforts come to nothing/futile
一塊	[jat1 faai3]one block/one piece/one (unit of money)/together/in the same place/in company
一塊兒	[jat1 faai3 ji4]erhua variant of 一塊|一块[yi1 kuai4]
一塊麵	[jat1 faai3 min6]loaf
一塌糊塗	[jat1 taap3 wu4 tou4]muddled and completely collapsing (idiom); in an awful condition/complete shambles/a total mess
一塵不染	[jat1 can4 bat1 jim5]untainted by even a speck of dust (idiom); selfless and incorruptible/spotless
一壁	[jat1 bik1]one side/at the same time
一壁廂	[jat1 bik1 soeng1]see 一壁[yi1 bi4]
一多對應	[jat1 do1 deoi3 jing1]one-to-many correspondence
一夜爆紅	[jat1 je6 baau3 hung4]to become popular overnight
一夜露水	[jat1 je6 lou6 seoi2]one-night stand/ephemeral
一大早	[jat1 daai6 zou2]at dawn/at first light/first thing in the morning
一大早兒	[jat1 daai6 zou2 ji4]erhua variant of 一大早[yi1 da4 zao3]
一天一個樣	[jat1 tin1 jat1 go3 joeng6]to change from day to day
一天到晚	[jat1 tin1 dou3 maan5]all day long/the whole day
一夫一妻	[jat1 fu1 jat1 cai1]lit. one husband one wife/monogamy
一失足成千古恨	[jat1 sat1 zuk1 sing4 cin1 gu2 han6]lit. one wrong step causes thousand hatred (idiom)/A single slip may cause lasting sorrow.
一套	[jat1 tou3]suit/a set/a collection/of the same kind/the same old stuff/set pattern of behavior
一如	[jat1 jyu4]to be just like
一如所料	[jat1 jyu4 so2 liu6]as expected
一如既往	[jat1 jyu4 gei3 wong5]just as in the past (idiom); as before/continuing as always
一妻制	[jat1 cai1 zai3]monogamy
一孔之見	[jat1 hung2 zi1 gin3]partial view/limited outlook
一字	[jat1 zi6]in a row/in a line
一字一淚	[jat1 zi6 jat1 leoi6]each word is a teardrop (idiom)
一字不差	[jat1 zi6 bat1 caa1]word for word/verbatim
一字不提	[jat1 zi6 bat1 tai4]to not mention a single word (about sth) (idiom)
一字不識	[jat1 zi6 bat1 sik1]totally illiterate
一字之師	[jat1 zi6 zi1 si1]one who can correct a misread or misspelt character and thus be your master
一字千金	[jat1 zi6 cin1 gam1]one word worth a thousand in gold (idiom); valuable advice/words of enormous weight
一字巾	[jat1 zi6 gan1]headband/strip of cloth worn around the head
一字褒貶	[jat1 zi6 bou1 bin2]dispensing praise or blame with a single word (idiom)/concise and powerful style
一定	[jat1 ding6]surely/certainly/necessarily/fixed/a certain (extent etc)/given/particular/must
一定要	[jat1 ding6 jiu3]must
一家	[jat1 gaa1]the whole family/the same family/the family ... (when preceded by a family name)/group
一家之主	[jat1 gaa1 zi1 zyu2]master of the house/family head
一家人	[jat1 gaa1 jan4]household/the whole family
一家子	[jat1 gaa1 zi2]the whole family
一審	[jat1 sam2]first instance (law)
一寸光陰一寸金	[jat1 cyun3 gwong1 jam1 jat1 cyun3 gam1]lit. An interval of time is worth an ounce of gold. (idiom)/fig. free time is to be treasured
一對	[jat1 deoi3]couple/pair
一對一鬥牛	[jat1 deoi3 jat1 dau3 ngau4]one-on-one basketball game
一對兒	[jat1 deoi3 ji4]a pair/a couple
一小撮	[jat1 siu2 cyut3]handful (of)
一小部分	[jat1 siu2 bou6 fan1]a small part/a small section
一小陣兒	[jat1 siu2 zan6 ji4]very brief period of time
一局	[jat1 guk6]inning
一展身手	[jat1 zin2 san1 sau2]to showcase one's (unique) talents/to display one's (individual) prowess
一層	[jat1 cang4]layer
一巴掌	[jat1 baa1 zoeng2]a slap/a spank
一帆風順	[jat1 faan4 fung1 seon6]propitious wind throughout the journey (idiom)/plain sailing/to go smoothly/have a nice trip!
一席之地	[jat1 zik6 zi1 dei6](acknowledged) place/a role to play/niche
一席話	[jat1 zik6 waa6]the content of a conversation/words/remarks
一帶	[jat1 daai3]region/district
一帶而過	[jat1 daai3 ji4 gwo3]to skate around/to skip over/to skimp
一年之計在於春	[jat1 nin4 zi1 gai3 zoi6 jyu1 ceon1]the whole year must be planned for in the spring (idiom)/early planning is the key to success
一年到頭	[jat1 nin4 dou3 tau4]all year round
一年半	[jat1 nin4 bun3]a year and a half
一年半載	[jat1 nin4 bun3 zoi3]about a year
一年四季	[jat1 nin4 sei3 gwai3]all year round
一年多	[jat1 nin4 do1]more than a year
一年期	[jat1 nin4 kei4]one year period (in a contract or budget)
一年生	[jat1 nin4 saang1]annual (botany)
一年被蛇咬十年怕井繩	[jat1 nin4 bei6 se4 ngaau5 sap6 nin4 paa3 zeng2 sing4]bitten by a snake in one year, fears the well rope for ten years (idiom); once bitten twice shy
一度	[jat1 dou6]for a time/at one time/one time/once
一廂情願	[jat1 soeng1 cing4 jyun6]one's own wishful thinking
一式二份	[jat1 sik1 ji6 fan6]in duplicate
一彈指頃	[jat1 daan2 zi2 king2]a snap of the fingers (idiom); in a flash/in the twinkling of an eye
一往情深	[jat1 wong5 cing4 sam1]deeply attached/devoted
一往無前	[jat1 wong5 mou4 cin4]to advance courageously (idiom)/to press forward
一往直前	[jat1 wong5 zik6 cin4]see 一往無前|一往无前[yi1 wang3 wu2 qian2]
一律	[jat1 leot6]same/uniformly/all/without exception
一徑	[jat1 ging3]directly/straightaway/straight
一心	[jat1 sam1]wholeheartedly/heart and soul
一心一德	[jat1 sam1 jat1 dak1]of one heart and one mind (idiom)
一心一意	[jat1 sam1 jat1 ji3]concentrating one's thoughts and efforts/single-minded/bent on/intently
一心二用	[jat1 sam1 ji6 jung6]to do two things at once (idiom)/to multitask/to divide one's attention
一念之差	[jat1 nim6 zi1 caa1]momentary slip/false step/ill-considered action
一愁莫展	[jat1 sau4 mok6 zin2]nothing one can do about it
一意	[jat1 ji3]focus/with complete devotion/stubbornly
一意孤行	[jat1 ji3 gu1 hang4]obstinately clinging to one's course (idiom)/willful/one's own way/dogmatic
一應	[jat1 jing1]all/every
一應俱全	[jat1 jing1 keoi1 cyun4]with everything needed available
一成不變	[jat1 sing4 bat1 bin3]nothing much changes (idiom); always the same/stuck in a rut
一房一廳	[jat1 fong4 jat1 teng1]one bedroom and one living room
一手	[jat1 sau2]a skill/mastery of a trade/by oneself/without outside help
一手包辦	[jat1 sau2 baau1 baan6]to take care of a matter all by oneself/to run the whole show
一手遮天	[jat1 sau2 ze1 tin1]lit. to hide the sky with one hand/to hide the truth from the masses
一打	[jat1 daa2]dozen
一技之長	[jat1 gei6 zi1 coeng4]proficiency in a particular field (idiom)/skill in a specialized area (idiom)
一把好手	[jat1 baa2 hou2 sau2]expert/dab hand
一把屎一把尿	[jat1 baa2 si2 jat1 baa2 niu6]to have endured all sorts of hardships (to raise one's children) (idiom)
一把手	[jat1 baa2 sau2]working hand/member of a work team/participant
一把抓	[jat1 baa2 zaa1]to attempt all tasks at once/to manage every detail regardless of its importance
一把死拿	[jat1 baa2 sei2 naa4]stubborn/inflexible
一把眼淚一把鼻涕	[jat1 baa2 ngaan5 leoi6 jat1 baa2 bei6 tai3]with one's face covered in tears (idiom)
一把鑰匙開一把鎖	[jat1 baa2 joek6 ci4 hoi1 jat1 baa2 so2]One key opens one lock./There is a different solution for each problem. (idiom)
一抓一大把	[jat1 zaa1 jat1 daai6 baa2]a dime a dozen/a great deal of
一折兩段	[jat1 zit3, loeng5 dyun6]to split sth into two (idiom)
一抿子	[jat1 man5 zi2]a little bit
一拍兩散	[jat1 paak3 loeng5 saan3]lit. on the beat, move apart; fig. break-up (of marriage or business partners)/separation
一拍即合	[jat1 paak3 zik1 hap6]lit. on the beat, together now (idiom); Start dancing!/fig. things fit together at one go/to click together/to chime in easily
一掃而光	[jat1 sou3 ji4 gwong1]to clear off/to make a clean sweep of
一掃而空	[jat1 sou3 ji4 hung1]to sweep clean/to clean out
一排	[jat1 paai4]row
一揮而就	[jat1 fai1 ji4 zau6]to finish (a letter, a painting) at a stroke
一撥兒	[jat1 but6 ji4]group of people
一擁而上	[jat1 jung2 ji4 soeng6]to swarm around/flocking (to see)
一擁而入	[jat1 jung2 ji4 jap6]to swarm in (of people etc) (idiom)
一擊入洞	[jat1 gik1 jap6 dung6]hole in one (golf)
一擲千金	[jat1 zaak6 cin1 gam1]lit. stake a thousand pieces of gold on one throw (idiom); to throw away money recklessly/extravagant
一攬子	[jat1 laam2 zi2]all-inclusive/undiscriminating
一改故轍	[jat1 goi2 gu3 cit3]complete change from the old rut (idiom); dramatic change of direction/a volte-face/to change old practices
一敗塗地	[jat1 baai6 tou4 dei6]failed and wiped over the floor (idiom); to fail utterly/a crushing defeat/beaten and in a hopeless position
一文不值	[jat1 man4 bat1 zik6]worthless (idiom)/no use whatsoever
一文不名	[jat1 man4 bat1 ming4]to be penniless
一斑	[jat1 baan1]lit. one spot (on the leopard)/fig. one small item in a big scheme
一方	[jat1 fong1]a party (in a contract or legal case)/one side/area/region
一方面	[jat1 fong1 min6]one aspect is
一旁	[jat1 pong4]aside/to the side of
一族	[jat1 zuk6]social group/subculture/family/clan/see also 族[zu2]
一日三秋	[jat1 jat6 saam1 cau1]a single day apart seems like three seasons (idiom)
一日三餐	[jat1 jat6 saam1 caan1]to have three meals a day
一日之雅	[jat1 jat6 zi1 ngaa5]lit. friends for a day (idiom)/fig. casual acquaintance
一日千里	[jat1 jat6 cin1 lei5]lit. one day, a thousand miles (idiom); rapid progress
一旦	[jat1 daan3]in case (sth happens)/if/once (sth happens, then...)/when/in a short time/in one day
一早	[jat1 zou2]early in the morning/at dawn
一星半點	[jat1 sing1 bun3 dim2]just the tiniest bit/a hint of
一時	[jat1 si4]a period of time/a while/for a short while/temporary/momentary/at the same time
一時半刻	[jat1 si4 bun3 hak1]a short time/a little while
一時半晌	[jat1 si4 bun3 hoeng2]a short time/a little while
一時半會	[jat1 si4 bun3 wui5]a short time/a little while
一時半會兒	[jat1 si4 bun3 wui5 ji4]a short time/a little while
一時半霎	[jat1 si4 bun3 saap3]a short time/a little while
一時間	[jat1 si4 gaan1]for a moment/momentarily
一晃	[jat1 fong2](of passing time) in an instant/(of a sight) in a flash
一暴十寒	[jat1 bou6 sap6 hon4]one day's sun, ten days' frost (idiom, from Mencius); fig. to work for a bit then skimp/sporadic effort/short attention span
一曝十寒	[jat1 buk6 sap6 hon4]one day's sun, ten days' frost (idiom, from Mencius); fig. to work for a bit then skimp/sporadic effort/lack of sticking power/short attention span
一更	[jat1 gang1]first of the five night watch periods 19:00-21:00 (old)
一會	[jat1 wui5]a moment/a while/in a moment/also pr. [yi1 hui3]
一會兒	[jat1 wui5 ji4]a moment/a while/in a moment/now...now.../also pr. [yi1 hui3 r5]
一月	[jat1 jyut6]January/first month (of the lunar year)
一月份	[jat1 jyut6 fan6]January
一望無際	[jat1 mong6 mou4 zai3]as far as the eye can see (idiom)
一望而知	[jat1 mong6 ji4 zi1]to be evident at a glance (idiom)
一朝一夕	[jat1 ziu1 jat1 zik6]lit. one morning and one evening (idiom)/fig. in a short period of time/overnight
一木難支	[jat1 muk6 naan4 zi1]lit. a single post cannot prop up a falling house (idiom)/fig. one is helpless alone
一本正經	[jat1 bun2 zing3 ging1]in deadly earnest/deadpan
一杯羹	[jat1 bui1 gang1]lit. a cup of soup/fig. to get part of the profits/one's share of the action
一東一西	[jat1 dung1 jat1 sai1]far apart
一板一眼	[jat1 baan2 jat1 ngaan5]lit. one strong beat and one weak beats in a measure of music (two beats in the bar) (idiom); fig. follow a prescribed pattern to the letter/scrupulous attention to detail
一板三眼	[jat1 baan2 saam1 ngaan5]lit. one strong beat and three weak beats in a measure of music (four beats in the bar) (idiom); fig. scrupulous attention to detail
一枝獨秀	[jat1 zi1 duk6 sau3]lit. only one branch of the tree is thriving (idiom)/fig. to be in a league of one's own/outstanding
一柱擎天	[jat1 cyu5 king4 tin1]lit. to support the sky as a single pillar (idiom)/fig. to take a crucial responsibility upon one's shoulders
一根筋	[jat1 gan1 gan1]stubborn/inflexible/one-track minded
一根繩上的螞蚱	[jat1 gan1 sing4 soeng6 dik1 maa5 zaa3]see 一條繩上的螞蚱|一条绳上的蚂蚱[yi1 tiao2 sheng2 shang4 de5 ma4 zha5]
一桿進洞	[jat1 gon1 zeon3 dung6](golf) hole in one
一條心	[jat1 tiu4 sam1]to be of one mind/to think or act alike
一條繩上的螞蚱	[jat1 tiu4 sing4 soeng6 dik1 maa5 zaa3]lit. like locusts tied to one rope (idiom)/fig. in the same boat/in it together for better or worse/to sink or swim together
一條道走到黑	[jat1 tiu4 dou6 zau2 dou3 hak1]to stick to one's ways/to cling to one's course
一條龍服務	[jat1 tiu4 lung4 fuk6 mou6]one-stop service
一概	[jat1 koi3]all/without any exceptions/categorically
一概而論	[jat1 koi3 ji4 leon6]to lump different matters together (idiom)
一槌定音	[jat1 ceoi4 ding6 jam1]variant of 一錘定音|一锤定音[yi1 chui2 ding4 yin1]
一模一樣	[jat1 mou4 jat1 joeng6]exactly the same (idiom)/carbon copy/also pr. [yi1 mo2 yi1 yang4]
一樣	[jat1 joeng6]same/like/equal to/the same as/just like
一次	[jat1 ci3]first/first time/once/(math.) linear (of degree one)
一次函數	[jat1 ci3 haam4 sou3]linear function (math.)
一次又一次	[jat1 ci3 jau6 jat1 ci3]repeatedly/over and over again
一次性	[jat1 ci3 sing3]one-off (offer)/one-time/single-use/disposable (goods)
一次方程	[jat1 ci3 fong1 cing4]linear equation
一次方程式	[jat1 ci3 fong1 cing4 sik1]linear equation (math.)
一次總付	[jat1 ci3 zung2 fu6]lump-sum (finance)
一步一個腳印	[jat1 bou6 jat1 go3 goek3 jan3]one step, one footprint (idiom); steady progress/reliable
一步一趨	[jat1 bou6 jat1 ceoi1]see 亦步亦趨|亦步亦趋[yi4 bu4 yi4 qu1]
一步到位	[jat1 bou6 dou3 wai6]to settle a matter in one go
一步登天	[jat1 bou6 dang1 tin1]reaching heaven in a single bound (idiom); (esp. with negative: don't expect) instant success
一毛不拔	[jat1 mou4 bat1 bat6]stingy (idiom)
一氣	[jat1 hei3]at one go/at a stretch/for a period of time/forming a gang
一氣之下	[jat1 hei3 zi1 haa6]in a fit of pique/in a fury
一氣呵成	[jat1 hei3 ho1 sing4]to do something at one go/to flow smoothly
一氧化二氮	[jat1 joeng5 faa3 ji6 daam6]nitrous oxide N2O/laughing gas
一氧化氮	[jat1 joeng5 faa3 daam6]nitric oxide
一氧化碳	[jat1 joeng5 faa3 taan3]carbon monoxide CO
一水兒	[jat1 seoi2 ji4](coll.) of the same type/identical
一決雌雄	[jat1 kyut3 ci1 hung4]to have a show-down/to fight for mastery/to compete for a championship
一波三折	[jat1 bo1 saam1 zit3,]calligraphic flourish with many twists/fig. many twists and turns
一派胡言	[jat1 paai3 wu4 jin4]a bunch of nonsense
一派謊言	[jat1 paai3 fong1 jin4]a pack of lies
一清二楚	[jat1 cing1 ji6 co2]to be very clear about sth (idiom)
一清二白	[jat1 cing1 ji6 baak6]perfectly clean/blameless/unimpeachable (idiom)
一清如水	[jat1 cing1 jyu4 seoi2]lit. as clear as water (idiom)/fig. (of officials etc) honest and incorruptible
一清早	[jat1 cing1 zou2]early in the morning
一準	[jat1 zeon2]certainly
一溜煙	[jat1 lau4 jin1]like a wisp of smoke/(to disappear etc) in an instant
一潭死水	[jat1 taam4 sei2 seoi2]a pool of stagnant water/stagnant or listless condition
一炮打響	[jat1 paau3 daa2 hoeng2]to win instant success (idiom)/to start off successfully
一炮而紅	[jat1 paau3 ji4 hung4]to win instant success (idiom)/to become an instant hit
一無所動	[jat1 mou4 so2 dung6]totally unaffected/unimpressed
一無所有	[jat1 mou4 so2 jau5]not having anything at all (idiom); utterly lacking/without two sticks to rub together
一無所獲	[jat1 mou4 so2 wok6]to gain nothing/to end up empty-handed
一無所知	[jat1 mou4 so2 zi1]not knowing anything at all (idiom); completely ignorant/without an inkling
一無所聞	[jat1 mou4 so2 man4]unheard of
一無所長	[jat1 mou4 so2 coeng4]not having any special skill/without any qualifications
一無是處	[jat1 mou4 si6 cyu3]not one good point/everything about it is wrong
一片	[jat1 pin3]piece/slice
一物降一物	[jat1 mat6 hong4 jat1 mat6]lit. one object bests another object/every item has a weakness (idiom)/there is a rock to every scissor, a scissor to every paper, and a paper to every rock
一琴一鶴	[jat1 kam4 jat1 hok6]carrying very little luggage (idiom)/honest and incorruptible (government officials)
一生	[jat1 saang1]all one's life/throughout one's life
一生一世	[jat1 saang1 jat1 sai3]a whole lifetime (idiom); all my life
一甲子	[jat1 gaap3 zi2]sixty years
一病不起	[jat1 beng6 bat1 hei2]to fall gravely ill, never to recover (idiom)
一瘸一拐	[jat1 ke4 jat1 gwaai2]to limp/to hobble
一發不可收拾	[jat1 faat3 bat1 ho2 sau1 sap6]things that have happened can hardly be controlled/to get out of hand
一百一	[jat1 baak3 jat1]faultless/impeccable
一盤散沙	[jat1 pun4 saan3 saa1]lit. like a sheet of loose sand/fig. unable to cooperate (idiom)
一目了然	[jat1 muk6 liu5 jin4]obvious at a glance (idiom)
一目十行	[jat1 muk6 sap6 hang4]ten lines at a glance (idiom)/to read very rapidly
一目瞭然	[jat1 muk6 liu5 jin4]obvious at a glance (idiom)
一直	[jat1 zik6]straight (in a straight line)/continuously/always/from the beginning of ... up to .../all along
一直以來	[jat1 zik6 ji5 loi4]in the past always/for a long time now/until now
一直往前	[jat1 zik6 wong5 cin4]straight ahead
一相情願	[jat1 soeng1 cing4 jyun6]one's own wishful thinking
一眨眼	[jat1 zaap3 ngaan5]in a wink
一眼	[jat1 ngaan5]a glance/a quick look/a glimpse
一眼望去	[jat1 ngaan5 mong6 heoi3]as far as the eye can see
一眼看穿	[jat1 ngaan5 hon3 cyun1]to see through something at first glance (idiom)
一睹	[jat1 dou2]to look/to have a glimpse at/to observe (sth's splendor)
一瞥	[jat1 pit3]glance/glimpse
一瞬	[jat1 seon3]one instant/very short time/the twinkle of an eye
一瞬間	[jat1 seon3 gaan1]split second
一矢中的	[jat1 ci2 zung1 dik1]to hit the target with a single shot/to say something spot on (idiom)
一知半解	[jat1 zi1 bun3 gaai2]lit. to know one and understand half (idiom); a smattering of knowledge/dilettante/amateur
一石二鳥	[jat1 sek6 ji6 niu5]to kill two birds with one stone (idiom)
一神教	[jat1 san4 gaau3]monotheism (belief in a single God)
一神論	[jat1 san4 leon6]monotheism/unitarianism (denying the Trinity)
一秉虔誠	[jat1 bing2 kin4 sing4]earnestly and sincerely (idiom); devoutly
一秘	[jat1 bei3]first secretary
一種	[jat1 zung2]one kind of/one type of
一空	[jat1 hung1](sold etc) out
一窩蜂	[jat1 wo1 fung1]like a swarm of bees/everyone swarms around pushing and shouting/a hornet's nest
一窮二白	[jat1 kung4 ji6 baak6]impoverished/backward both economically and culturally
一竅不通	[jat1 hiu3 bat1 tung1]lit. doesn't (even) enter a single aperture (of one's head)/I don't understand a word (idiom)/it's all Greek to me
一笑了之	[jat1 siu3 liu5 zi1]to laugh away (instead of taking seriously)
一笑置之	[jat1 siu3 zi3 zi1]to dismiss with a laugh/to make light of
一筆不苟	[jat1 bat1 bat1 gau2]lit. not even one stroke is negligent (idiom)/fig. to write characters (calligraphy) in which every stroke is placed perfectly
一筆抹殺	[jat1 bat1 maat3 saat3]to blot out at one stroke/to reject out of hand/to deny without a hearing
一筆抹煞	[jat1 bat1 maat3 saat3]variant of 一筆抹殺|一笔抹杀[yi1 bi3 mo3 sha1]
一等	[jat1 dang2]first class/grade A
一等獎	[jat1 dang2 zoeng2]first prize
一箭之仇	[jat1 zin3 zi1 sau4]a wrong suffered (idiom)/old grievance/previous defeat
一節詩	[jat1 zit3 si1]stanza
一籌莫展	[jat1 cau4 mok6 zin2]to be unable to find a solution/to be at wits' end
一籮筐	[jat1 lo4 hong1]bucketloads of/in large quantities/extremely
一粒老鼠屎壞了一鍋粥	[jat1 nap1 lou5 syu2 si2 waai6 liu5 jat1 wo1 zuk1]lit. a piece of rat feces spoiled the whole pot of congee (idiom)/fig. one bad apple can spoil the whole bunch
一系列	[jat1 hai6 lit6]a series of/a string of
一紙空文	[jat1 zi2 hung1 man4]a worthless piece of paper (idiom)
一級	[jat1 kap1]first class/category A
一級士官	[jat1 kap1 si6 gun1]corporal (army)
一級方程式	[jat1 kap1 fong1 cing4 sik1]Formula One
一級棒	[jat1 kap1 paang5]first-rate/excellent (loanword from Japanese 一番, ichiban)
一級頭	[jat1 kap1 tau4]first stage (diving)
一統	[jat1 tung2]to unify/unified
一絲一毫	[jat1 si1 jat1 hou4]one thread, one hair (idiom); a tiny bit/an iota
一絲不掛	[jat1 si1 bat1 gwaa3]not wearing one thread (idiom); absolutely naked/without a stitch of clothing/in one's birthday suit
一絲不苟	[jat1 si1 bat1 gau2]not one thread loose (idiom); strictly according to the rules/meticulous/not one hair out of place
一維	[jat1 wai4]one-dimensional (math.)
一網打盡	[jat1 mong5 daa2 zeon6]to catch everything in one net (idiom); to eliminate at one stroke/to solve the problem at one fell swoop
一線	[jat1 sin3]front line
一線之間	[jat1 sin3 zi1 gaan1]a hair's breadth apart/a fine line/a fine distinction
一線之隔	[jat1 sin3 zi1 gaak3]a fine line/a fine distinction
一線希望	[jat1 sin3 hei1 mong6]a gleam of hope
一線微光	[jat1 sin3 mei4 gwong1]gleam
一總	[jat1 zung2]altogether/in all
一聲	[jat1 sing1]first tone in Mandarin (high level tone)
一聲不響	[jat1 sing1 bat1 hoeng2]to keep totally silent/noiselessly
一肚子	[jat1 tou5 zi2]bellyful (of sth)/full of (sth)
一肚皮	[jat1 tou5 pei4]bellyful (of sth)/full of (sth)
一股子	[jat1 gu2 zi2]a whiff of/a taint of/a thread of
一股腦	[jat1 gu2 nou5]all of it/lock, stock and barrel
一股腦兒	[jat1 gu2 nou5 ji4]erhua variant of 一股腦|一股脑[yi1 gu3 nao3]
一胎制	[jat1 toi1 zai3]the one-child policy
一胎化	[jat1 toi1 faa3]practice of allowing only one child per family
一脈相承	[jat1 mak6 soeng1 sing4]traceable to the same stock (idiom); of a common origin (of trends, ideas etc)
一腔	[jat1 hong1]full of (zeal, anger etc)
一臂之力	[jat1 bei3 zi1 lik6](lend) a helping hand
一臉茫然	[jat1 lim5 mong4 jin4]puzzled/bewildered
一致	[jat1 zi3]unanimous/identical (views or opinions)
一致字	[jat1 zi3 zi6]consistent phonogram(s)
一致性	[jat1 zi3 sing3]consistency
一致性效應	[jat1 zi3 sing3 haau6 jing1]consistency effect
一致資源定址器	[jat1 zi3 zi1 jyun4 ding6 zi2 hei3]uniform resource locator (URL), i.e. web address
一舉	[jat1 geoi2]a move/an action/in one move/at a stroke/in one go
一舉一動	[jat1 geoi2 jat1 dung6]every movement/each and every move
一舉兩得	[jat1 geoi2 loeng5 dak1]one move, two gains (idiom); two birds with one stone
一舉成功	[jat1 geoi2 sing4 gung1]success at one go/to succeed at the first attempt
一舉手一投足	[jat1 geoi2 sau2 jat1 tau4 zuk1]every little move/every single movement
一般	[jat1 bun1]same/ordinary/so-so/common/general/generally/in general
一般人	[jat1 bun1 jan4]average person
一般來說	[jat1 bun1 loi4 syut3]generally speaking
一般來講	[jat1 bun1 loi4 gong2]generally speaking
一般原則	[jat1 bun1 jyun4 zak1]general principle
一般性	[jat1 bun1 sing3]general/in general terms/generalized
一般而言	[jat1 bun1 ji4 jin4]generally speaking
一般見識	[jat1 bun1 gin3 sik1]to lower oneself to sb's level/to argue with sb less well-informed
一般規定	[jat1 bun1 kwai1 ding6]ordinary provision (law)
一般說來	[jat1 bun1 syut3 loi4]generally speaking/in general
一般貿易	[jat1 bun1 mau6 ji6]general trade (i.e. importing and export without processing)
一落千丈	[jat1 lok6 cin1 zoeng6]lit. to drop a thousand zhang in one fall (idiom)/fig. (of business, popularity etc) to suffer a sudden, devastating decline/to take a dive
一葉知秋	[jat1 jip6 zi1 cau1]lit. the falling of one leaf heralds the coming of autumn (idiom)/fig. a small sign can indicate a great trend/a straw in the wind
一葉障目	[jat1 jip6 zoeng3 muk6]lit. eyes obscured by a single leaf (idiom)/fig. not seing the wider picture/can't see the wood for the trees
一號	[jat1 hou6]first day of the month/toilet/(slang) giver (in a homosexual relationship)
一號木桿	[jat1 hou6 muk6 gon1]driver (golf)
一號電池	[jat1 hou6 din6 ci4]D size battery
一行	[jat1 hang4]party/delegation
一衣帶水	[jat1 ji1 daai3 seoi2](separated only by) a narrow strip of water
一見傾心	[jat1 gin3 king1 sam1]love at first sight
一見如故	[jat1 gin3 jyu4 gu3]familiarity at first sight
一見鐘情	[jat1 gin3 zung1 cing4]love at first sight (idiom)
一見高低	[jat1 gin3 gou1 dai1]lit. to fight it out with sb to see who is best (idiom)/fig. to cross swords with/to lock horns
一視同仁	[jat1 si6 tung4 jan4]to treat everyone equally favorably (idiom); not to discriminate between people
一親芳澤	[jat1 can1 fong1 zaak6]to get close to/to get on intimate terms with
一覺醒來	[jat1 gok3 sing2 loi4]to wake up from a sleep
一覽	[jat1 laam5]an overview/at a glance
一覽無遺	[jat1 laam5 mou4 wai4]be plainly visible
一覽無餘	[jat1 laam5 mou4 jyu4]to cover all at one glance (idiom)/a panoramic view
一角銀幣	[jat1 gok3 ngan4 bai6]dime
一觸即潰	[jat1 zuk1 zik1 kui2]to collapse on the first encounter/to give way at once
一觸即發	[jat1 zuk1 zik1 faat3]could happen at any moment/on the verge
一言	[jat1 jin4]one sentence/brief remark
一言一動	[jat1 jin4 jat1 dung6](one's) every word and deed (idiom)
一言一行	[jat1 jin4 jat1 hang4]every word and action (idiom)
一言不發	[jat1 jin4 bat1 faat3]to not say a word (idiom)
一言九鼎	[jat1 jin4 gau2 ding2]one word worth nine sacred tripods (idiom); words of enormous weight
一言以蔽之	[jat1 jin4 ji5 bai3 zi1]one word says it all (idiom, from Analects); to cut a long story short/in a nutshell
一言千金	[jat1 jin4 cin1 gam1]one word worth a thousand in gold (idiom); valuable advice/words of enormous weight
一言抄百總	[jat1 jin4 caau1 baak3 zung2]to cut a long story short
一言為定	[jat1 jin4 wai4 ding6]one word and it's settled (idiom); It's a deal!/That's settled then.
一言為重	[jat1 jin4 wai4 cung5]each word carries weight/a promise must be kept (idiom)
一言難盡	[jat1 jin4 naan4 zeon6]hard to explain in a few words (idiom); complicated and not easy to express succinctly
一語不發	[jat1 jyu5 bat1 faat3]to not say a word (idiom)
一語中的	[jat1 jyu5 zung1 dik1]to hit the mark with a comment (idiom)/to say sth spot on
一語破的	[jat1 jyu5 po3 dik1]see 一語中的|一语中的[yi1 yu3 zhong4 di4]
一語道破	[jat1 jyu5 dou6 po3]one word says it all (idiom)/to hit the nail on the head/to be pithy and correct
一語雙關	[jat1 jyu5 soeng1 gwaan1]to make a pun/to have a double meaning/double entendre
一諾千金	[jat1 nok6 cin1 gam1]a promise worth one thousand in gold (idiom); a promise that must be kept
一貧如洗	[jat1 pan4 jyu4 sai2]penniless
一貫	[jat1 gun3]consistent/constant/from start to finish/all along/persistent
一走了之	[jat1 zau2 liu5 zi1]to avoid a problem by walking away from it/to quit
一起	[jat1 hei2]in the same place/together/with/altogether (in total)
一路	[jat1 lou6]the whole journey/all the way/going the same way/going in the same direction/of the same kind
一路來	[jat1 lou6 loi4]all the way/all along/since the start
一路平安	[jat1 lou6 ping4 on1]to have a pleasant journey/Bon voyage!
一路發	[jat1 lou6 faat3]fortune street (idiom)
一路順風	[jat1 lou6 seon6 fung1]to have a pleasant journey (idiom)
一路風塵	[jat1 lou6 fung1 can4]to live an exhausting journey
一蹶不振	[jat1 kyut3 bat1 zan3]one stumble, unable to rise (idiom); a setback leading to total collapse/ruined at a stroke/unable to recover after a minor hitch
一躍而起	[jat1 joek6 ji4 hei2]to jump up suddenly/to bound up/to rise up in one bound
一身	[jat1 san1]whole body/from head to toe/single person/a suit of clothes
一身兩役	[jat1 san1 loeng5 jik6]one person taking on two tasks simultaneously
一身是膽	[jat1 san1 si6 daam2]devoid of fear (idiom)/intrepid
一身汗	[jat1 san1 hon6]sweating all over
一較高下	[jat1 gaau3 gou1 haa6]to compete against/to measure oneself against/to go head to head (see who is best)
一輩子	[jat1 bui3 zi2](for) a lifetime
一輪	[jat1 leon4]first round or stage (of a match, election, talks, planned policy etc)
一轉眼	[jat1 zyun2 ngaan5]in a wink
一辭莫贊	[jat1 ci4 mok6 zaan3]to be unable to offer an opinion (idiom)
一退六二五	[jat1 teoi3 luk6 ji6 ng5]lit. 1 divided by 16 is 0.0625 (abacus rule)/fig. to deny responsibility/to pass the buck/also written 一推六二五[yi1 tui4 liu4 er4 wu3]
一通百通	[jat1 tung1 baak3 tung1]grasp this fundamental point and all the rest will follow (idiom)
一連	[jat1 lin4]in a row/in succession/running
一連串	[jat1 lin4 cyun3]a chain of (events, errors, jobs, problems, successes etc)/a succession of (disasters)/a series/a row (of stores)
一遍	[jat1 pin3]one time (all the way through)/once through
一遍又一遍	[jat1 pin3 jau6 jat1 pin3]over and over
一過性	[jat1 gwo3 sing3]transient
一道	[jat1 dou6]together
一遞一個	[jat1 dai6 jat1 go3]one after another
一遞一聲	[jat1 dai6 jat1 sing1](of singers etc) one answering the other
一邊	[jat1 bin1]one side/either side/on the one hand/on the other hand/doing while
一部分	[jat1 bou6 fan1]portion/part of/subset
一醉方休	[jat1 zeoi3 fong1 jau1]to get thoroughly drunk (idiom)/to get plastered
一針見血	[jat1 zam1 gin3 hyut3]lit. to draw blood on the first prick (idiom)/fig. to hit the nail on the head
一錘子買賣	[jat1 ceoi4 zi2 maai5 maai6]lit. fly-by-night one-off business deal/fig. to act recklessly, throwing all caution to the wind
一錘定音	[jat1 ceoi4 ding6 jam1]lit. to fix the tone with a single hammer blow/fig. to make the final decision
一錢不值	[jat1 cin4 bat1 zik6]not worth a penny/utterly worthless
一錢如命	[jat1 cin4 jyu4 ming6]stingy/penny-pinching
一錯再錯	[jat1 co3 zoi3 co3]to repeat errors/to continue blundering/to make continuous mistakes
一鍋粥	[jat1 wo1 zuk1](lit.) a pot of porridge/(fig.) a complete mess
一門心思	[jat1 mun4 sam1 si1]to set one's heart on sth (idiom)
一閃念	[jat1 sim2 nim6]sudden idea/flash of insight
一閃而過	[jat1 sim2 ji4 gwo3]to flash past/to flit by
一陣	[jat1 zan6]a burst/a fit/a peal/a spell (period of time)
一陣子	[jat1 zan6 zi2]short period of time/while (time)/fit of anger
一雨成秋	[jat1 jyu5 sing4 cau1]a sudden shower towards the end of summer brings an abrupt arrival of autumn (idiom)
一霎	[jat1 saap3]in a flash
一霎時	[jat1 saap3 si4]in an instant
一霎眼	[jat1 saap3 ngaan5]suddenly/in an instant
一霎間	[jat1 saap3 gaan1]in a flash
一靈真性	[jat1 ling4 zan1 sing3]soul/spirit
一面	[jat1 min6]one side/one aspect/simultaneously... (and...)/one's whole face
一面之交	[jat1 min6 zi1 gaau1]to have met once/casual acquaintance
一面之詞	[jat1 min6 zi1 ci4]one side of the story/one-sided statement
一面倒	[jat1 min6 dou2]one-sided/lopsided/unanimous/overwhelming majority
一項一項地	[jat1 hong6 jat1 hong6 dei6]one by one
一頭	[jat1 tau4]one head/a head full of sth/one end (of a stick)/one side/headlong/directly/rapidly/simultaneously
一頭栽進	[jat1 tau4 zoi1 zeon3]to plunge into/to run headlong into
一顆老鼠屎壞了一鍋湯	[jat1 fo2 lou5 syu2 si2 waai6 liu5 jat1 wo1 tong1]lit. a piece of rat feces spoiled the whole pot of soup (idiom)/fig. one bad apple can spoil the whole bunch
一顆老鼠屎壞了一鍋粥	[jat1 fo2 lou5 syu2 si2 waai6 liu5 jat1 wo1 zuk1]see 一粒老鼠屎壞了一鍋粥|一粒老鼠屎坏了一锅粥[yi1 li4 lao3 shu3 shi3 huai4 le5 yi1 guo1 zhou1]
一類	[jat1 leoi6]same type/category 1 (i.e. class A)
一類保護動物	[jat1 leoi6 bou2 wu6 dung6 mat6]class A protected animal
一飲而盡	[jat1 jam2 ji4 zeon6]to drain the cup in one gulp (idiom)
一飽眼福	[jat1 baau2 ngaan5 fuk1]to feast one's eyes on (idiom)
一馬平川	[jat1 maa5 ping4 cyun1]flat land one could gallop straight across (idiom); wide expanse of flat country
一馬當先	[jat1 maa5 dong1 sin1]to take the lead
一驚一乍	[jat1 geng1 jat1 zaa3]frightened/flustered
一體	[jat1 tai2]an integral whole/all concerned/everybody
一體兩面	[jat1 tai2 loeng5 min6]lit. one body two sides (idiom)/fig. a situation with two sides to it
一體化	[jat1 tai2 faa3]integration/incorporation/unification
一鬨而散	[jat1 hung3 ji4 saan3]see 一哄而散[yi1 hong1 er2 san4]
一鱗半爪	[jat1 leon4 bun3 zaau2]lit. one scale and half a claw (idiom); only odd bits and pieces
一鳴驚人	[jat1 ming4 geng1 jan4]to amaze the world with a single brilliant feat (idiom); an overnight celebrity
一黑早	[jat1 hak1 zou2]at dawn/early in the morning
一點	[jat1 dim2]a bit/a little/one dot/one point
一點一滴	[jat1 dim2 jat1 dik6]bit by bit/every little bit
一點一點	[jat1 dim2 jat1 dim2]little by little/bit by bit/gradually
一點不	[jat1 dim2 bat1]not at all
一點兒	[jat1 dim2 ji4]erhua variant of 一點|一点[yi1 dian3]
一點就通	[jat1 dim2 zau6 tung1]a hint is all that is needed/understanding each other without the need to explain
一點水一個泡	[jat1 dim2 seoi2 jat1 go3 pou5]honest and trustworthy (idiom)
一點鄰域	[jat1 dim2 leon4 wik6](math.) neighborhood of a point
一點點	[jat1 dim2 dim2]a little bit
一黨	[jat1 dong2]one party (state)
一黨專制	[jat1 dong2 zyun1 zai3]one party dictatorship
一鼓作氣	[jat1 gu2 zok3 hei3]in a spurt of energy
一鼻孔出氣	[jat1 bei6 hung2 ceot1 hei3]lit. to breathe through the same nostril (idiom); fig. two people say exactly the same thing (usually derog.)/to sing from the same hymn sheet
一齊	[jat1 cai4]at the same time/simultaneously
丁丁	[ding1 ding1]Tintin
丁丁	[ding1 ding1]sound of chopping wood, chess pieces hitting the board etc
丁丁炒面	[ding1 ding1 caau2 min6]chopped fried noodles
丁丑	[ding1 cau2]fourteenth year D2 of the 60 year cycle, e.g. 1997 or 2057
丁二烯	[ding1 ji6 hei1]butadiene C4H6/biethylene
丁二醇	[ding1 ji6 seon4]butyl glycol
丁亥	[ding1 hoi6]twenty fourth year D12 of the 60 year cycle, e.g. 2007 or 2067
丁克	[ding1 hak1]Dual Income, No Kids (DINK) (loanword)
丁內酯	[ding1 noi6 zi2]butyrolactone
丁冬	[ding1 dung1](onom.) ding dong/jingling of bells/clanking sound
丁加奴	[ding1 gaa1 nou4]Terengganu, northeast state of mainland Malaysia
丁卯	[ding1 maau5]fourth year D4 of the 60 year cycle, e.g. 1987 or 2047
丁型肝炎	[ding1 jing4 gon1 jim4]hepatitis D
丁基	[ding1 gei1]Ding Ji (1917-1944), real name Li Baicen 李百岑, journalist based in Yanan, martyr of the revolution
丁基	[ding1 gei1]butyl group (chemistry)
丁字	[ding1 zi6]T-shaped
丁字尺	[ding1 zi6 cek3]T-square/set square (carpenter's tool)
丁字梁	[ding1 zi6 loeng4]T-girder
丁字步	[ding1 zi6 bou6]T-step (basic dance position, with the feet forming a T shape)
丁字街	[ding1 zi6 gaai1]T-junction
丁字褲	[ding1 zi6 fu3]thong (underwear)
丁客	[ding1 haak3]see 丁克[ding1 ke4]
丁寧	[ding1 ning4]variant of 叮嚀|叮咛[ding1 ning2]
丁寵家庭	[ding1 cung2 gaa1 ting4]double income family who have pets rather than children (see also 丁克[ding1 ke4])
丁憂	[ding1 jau1](literary) to be in mourning after the death of a parent
丁未	[ding1 mei6]forty fourth year D8 of the 60 year cycle, e.g. 1967 or 2027
丁汝昌	[ding1 jyu5 coeng1]Ding Ruchang (1836-1895), commander of the Qing North China Navy
丁烯	[ding1 hei1]butene or butylene C4H8
丁玲	[ding1 ling4]Ding Ling (1904-1986), female novelist, author of novel The Sun Shines over the Sanggan River 太陽照在桑乾河上|太阳照在桑干河上, attacked during the 1950s as anti-Party
丁磊	[ding1 leoi5]Ding Lei (1971-), founder and CEO of NetEase 網易|网易[Wang3 yi4]
丁糖	[ding1 tong4]tetrose (CH20)4, monosaccharide with four carbon atoms
丁肇中	[ding1 siu6 zung1]Samuel C. C. Ting (1936-), American physicist, 1976 Nobel Prize laureate in physics
丁艱	[ding1 gaan1](literary) to be in mourning after the death of a parent
丁酉	[ding1 jau5]thirty fourth year D10 of the 60 year cycle, e.g. 1957 or 2017
丁醇	[ding1 seon4]butanol/butyl alcohol C4H9OH
丁醛	[ding1 cyun4]butyraldehyde/butanal
丁零噹啷	[ding1 ling4 dong1 long3]ding-a-ling/(onom.) for sound of bell
丁青	[ding1 ceng1]Dêngqên county, Tibetan: Steng chen rdzong, in Chamdo prefecture 昌都地區|昌都地区[Chang1 du1 di4 qu1], Tibet
丁青縣	[ding1 ceng1 jyun6]Dêngqên county, Tibetan: Steng chen rdzong, in Chamdo prefecture 昌都地區|昌都地区[Chang1 du1 di4 qu1], Tibet
丁香	[ding1 hoeng1]lilac (Syringia vulgaris)/clove (Eugenia aromatica)
丁骨牛排	[ding1 gwat1 ngau4 paai4]T-bone steak
丁鯛	[ding1 diu1]tench
丁點	[ding1 dim2]tiny bit
七七	[cat1 cat1]seven sevens (equals 49)/cf Buddhist services for the auspicious reincarnation of the departed
七七事變	[cat1 cat1 si6 bin3]Marco Polo Bridge Incident of 7th July 1937, regarded as the beginning of the Second Sino-Japanese War 抗日戰爭|抗日战争[Kang4 Ri4 Zhan4 zheng1]
七上八下	[cat1 soeng6 baat3 haa6]at sixes and sevens/perturbed state of mind/in a mess
七事	[cat1 si6]the Seven Duties of a sovereign, namely: offering sacrifice 祭祀, giving audience 朝覲|朝觐, administering jointly 會同|会同, receiving guests 賓客|宾客, running army 軍旅|军旅, attending to farm work 田役, mourning ceremonial 喪荒|丧荒
七分之一	[cat1 fan1 zi1 jat1]one seventh
七十	[cat1 sap6]seventy/70
七十七國集團	[cat1 sap6 cat1 gwok3 zaap6 tyun4]Group of 77
七十年代	[cat1 sap6 nin4 doi6]the seventies/the 1970s
七台河	[cat1 toi4 ho4]see 七台河市[Qi1 tai2 he2 shi4]
七台河市	[cat1 toi4 ho4 si5]Qitaihe prefecture level city, Heilongjiang province
七和弦	[cat1 wo4 jin4]seventh (musical cord)
七喜	[cat1 hei2]7 Up (soft drink)/Hedy Holding Co., PRC computer manufacturer
七嘴八張	[cat1 zeoi2 baat3 zoeng1]see 七嘴八舌[qi1 zui3 ba1 she2]
七國集團	[cat1 gwok3 zaap6 tyun4]G7, the group of 7 industrialized countries: US, Japan, Britain, Germany, France, Italy and Canada (now G8, including Russia)
七堵	[cat1 dou2]Chitu district of Keelung City 基隆市[Ji1 long2 shi4], Taiwan
七堵區	[cat1 dou2 keoi1]Chitu district of Keelung City 基隆市[Ji1 long2 shi4], Taiwan
七夕	[cat1 zik6]double seven festival, evening of seventh of lunar seventh month/girls' festival/Chinese Valentine's day, when Cowherd and Weaving maid 牛郎織女|牛郎织女 are allowed their annual meeting
七夕節	[cat1 zik6 zit3]Qixi Festival or Double Seven Festival on the 7th day of the 7th lunar month/girls' festival/Chinese Valentine's day, when Cowherd and Weaving maid 牛郎織女|牛郎织女[niu2 lang3 zhi1 nu:3] are allowed their annual meeting
七大工業國集團	[cat1 daai6 gung1 jip6 gwok3 zaap6 tyun4]G7, the group of 7 industrialized countries: US, Japan, Britain, Germany, France, Italy and Canada (now G8, including Russia)
七姊妹星團	[cat1 zi2 mui6 sing1 tyun4]Pleiades M45
七孔	[cat1 hung2]the seven apertures of the human head: 2 eyes, 2 ears, 2 nostrils, 1 mouth
七層架構	[cat1 cang4 gaa3 kau3]seven layer architecture (OSI)
七巧板	[cat1 haau2 baan2]tangram (traditional Chinese block puzzle)
七帶石斑魚	[cat1 daai3 sek6 baan1 jyu4]Epinephelus septemfasciatus
七年之癢	[cat1 nin4 zi1 joeng5]seven-year itch
七弦琴	[cat1 jin4 kam4]guqin or seven-stringed zither
七律	[cat1 leot6]abbr. for 七言律詩|七言律诗, verse form consisting of 8 lines of 7 syllables, with rhyme on alternate lines
七情	[cat1 cing4]seven emotional states/seven affects of traditional Chinese medical theory and therapy, namely: joy 喜[xi3], anger 怒[nu4], anxiety 憂|忧[you1], thought 思[si1], grief 悲[bei1], fear 恐[kong3], fright 驚|惊[jing1]/seven relations
七扭八歪	[cat1 nau2 baat3 waai1]in a state of great disorder (idiom)
七拼八湊	[cat1 ping3 baat3 cau3]assembled at random/a motley collection
七政四餘	[cat1 zing3 sei3 jyu4]seven heavenly bodies and four imaginary stars (in astrology and fengshui)
七方	[cat1 fong1](Chinese medicine) the seven kinds of prescriptions 大方, 小方, 缓方, 急方, 奇方, 偶方 and 重方 or 复方
七日熱	[cat1 jat6 jit6]leptospirosis
七旬老人	[cat1 ceon4 lou5 jan4]septuagenarian
七星	[cat1 sing1]Qixing district of Guilin city 桂林市[Gui4 lin2 shi4], Guangxi
七星區	[cat1 sing1 keoi1]Qixing district of Guilin city 桂林市[Gui4 lin2 shi4], Guangxi
七星瓢蟲	[cat1 sing1 piu4 cung4]seven-spotted ladybug (Coccinella septempunctata)
七曜	[cat1 jiu6]the seven planets of pre-modern astronomy (the Sun, the Moon, Mercury, Venus, Mars, Jupiter, and Saturn)
七月	[cat1 jyut6]July/seventh month (of the lunar year)
七月份	[cat1 jyut6 fan6]July
七武士	[cat1 mou5 si6]Seven Samurai (movie)
七河州	[cat1 ho4 zau1]Semirechye region of Kazakhstan, bordering Lake Balkash 巴爾喀什湖|巴尔喀什湖[Ba1 er3 ka1 shi2 Hu2]
七爺八爺	[cat1 je4 baat3 je4]see 黑白無常|黑白无常[Hei1 Bai2 Wu2 chang2]
七碳糖	[cat1 taan3 tong4]heptose (CH2O)7, monosaccharide with seven carbon atoms
七竅	[cat1 hiu3]the seven apertures of the human head: 2 eyes, 2 ears, 2 nostrils, 1 mouth
七竅生煙	[cat1 hiu3 saang1 jin1]lit. spouting smoke through the seven orifices (idiom)/fig. to seethe with anger
七級浮屠	[cat1 kap1 fau4 tou4]seven floor pagoda
七美	[cat1 mei5]Qimei or Chimei township in Penghu county 澎湖縣|澎湖县[Peng2 hu2 xian4] (Pescadores Islands), Taiwan
七美鄉	[cat1 mei5 hoeng1]Qimei or Chimei township in Penghu county 澎湖縣|澎湖县[Peng2 hu2 xian4] (Pescadores Islands), Taiwan
七聲	[cat1 sing1]tones of the musical scale
七聲音階	[cat1 sing1 jam1 gaai1]heptatonic scale
七股	[cat1 gu2]Chiku township in Tainan county 台南縣|台南县[Tai2 nan2 xian4], Taiwan
七股鄉	[cat1 gu2 hoeng1]Chiku township in Tainan county 台南縣|台南县[Tai2 nan2 xian4], Taiwan
七葉樹	[cat1 jip6 syu6]Chinese horse chestnut (Aesculus chinensis)
七葷八素	[cat1 fan1 baat3 sou3]confused/distracted
七號電池	[cat1 hou6 din6 ci4]AAA battery (PRC)/Taiwan equivalent: 四號電池|四号电池
七角形	[cat1 gok3 jing4]heptagon
七言律詩	[cat1 jin4 leot6 si1]verse form consisting of 8 lines of 7 syllables, with rhyme on alternate lines/abbr. to 七律
七邊形	[cat1 bin1 jing4]heptagon
七里河	[cat1 lei5 ho4]Qilihe District of Lanzhou City 蘭州市|兰州市[Lan2 zhou1 Shi4], Gansu
七里河區	[cat1 lei5 ho4 keoi1]Qilihe District of Lanzhou City 蘭州市|兰州市[Lan2 zhou1 Shi4], Gansu
七里香	[cat1 lei5 hoeng1]orange jasmine (Murraya paniculata)/"chicken butt", popular Taiwan snack on a stick, made of marinated "white cut chicken" butt
七零八碎	[cat1 ling4 baat3 seoi3]bits and pieces/scattered fragments
七零八落	[cat1 ling4 baat3 lok6](idiom) everything broken and in disorder
七項全能	[cat1 hong6 cyun4 nang4]heptathlon
七魄	[cat1 paak3]seven mortal forms in Daoism, representing carnal life and desires/contrasted with 三魂 three immortal souls
七鰓鰻	[cat1 soi1 maan6]lamprey (jawless proto-fish of family Petromyzontidae)
七龍珠	[cat1 lung4 zyu1]Dragon Ball, Japanese manga and anime series
丈二金剛摸不著頭腦	[zoeng6 ji6 gam1 gong1 mo2 bat1 zyu3 tau4 nou5]see 丈二和尚，摸不著頭腦|丈二和尚，摸不着头脑[zhang4 er2 he2 shang5 , mo1 bu5 zhao2 tou2 nao3]
丈人	[zoeng6 jan4]wife's father (father-in-law)/old man
丈夫	[zoeng6 fu1]husband
丈母	[zoeng6 mou5]wife's mother/mother-in-law
丈母娘	[zoeng6 mou5 noeng4]wife's mother/mother-in-law/same as 丈母
丈量	[zoeng6 loeng4]to measure/measurement
三七二十一	[saam1 cat1 ji6 sap6 jat1]three sevens are twenty-one (idiom)/the facts of the matter/the actual situation
三七仔	[saam1 cat1 zai2](slang) pimp
三七開	[saam1 cat1 hoi1]ratio seventy to thirty/thirty percent failure, seventy percent success
三七開定論	[saam1 cat1 hoi1 ding6 leon6]thirty percent failure, seventy percent success, the official PRC verdict on Mao Zedong
三三兩兩	[saam1 saam1 loeng5 loeng5]in twos and threes
三下五除二	[saam1 haa6 ng5 ceoi4 ji6]three, set five remove two (abacus rule)/efficiently/quickly and easily
三不	[saam1 bat1]the three no's (abbreviated catchphrase)
三不知	[saam1 bat1 zi1]to know nothing about the beginning, the middle or the end/to know nothing at all
三世	[saam1 sai3]the Third (of numbered kings)
三中全會	[saam1 zung1 cyun4 wui5]Third Plenum of the Chinese Communist Party, currently held every five years
三九天	[saam1 gau2 tin1]the twenty seven days after the Winter Solstice, reputed to be the coldest days of the year
三五成群	[saam1 ng5 sing4 kwan4]forming groups of three or squads of five (idiom); people stand around in small clumps
三井	[saam1 zeng2]Mitsui (Japanese company)
三亞	[saam1 aa3]Sanya prefecture level city, Hainan
三亞市	[saam1 aa3 si5]Sanya prefecture level city, Hainan
三人口氣	[saam1 jan4 hau2 hei3]third person (grammar)
三人成虎	[saam1 jan4 sing4 fu2]three men talking makes a tiger (idiom); repeated rumor becomes a fact
三人行	[saam1 jan4 hang4](slang) threesome
三仇	[saam1 sau4]animosity or resentment towards three groups (the bureaucrats, the wealthy, and the police) due to perceived abuse of power
三代	[saam1 doi6]third-generation
三代同堂	[saam1 doi6 tung4 tong4]three generations under one roof
三令五申	[saam1 ling6 ng5 san1]to order again and again (idiom)
三件套式西裝	[saam1 gin6 tou3 sik1 sai1 zong1]three-piece suit
三伏	[saam1 fuk6]three periods forming the hottest periods of summer, from mid-July to mid-August, namely: 初伏 (mid-July), 中伏 (late July to early August), 末伏 (mid-August)
三伏天	[saam1 fuk6 tin1]three periods forming the hottest periods of summer, from mid-July to mid-August, namely: 初伏 (mid-July), 中伏 (late July to early August), 末伏 (mid-August)
三位一體	[saam1 wai6 jat1 tai2]Holy Trinity/trinity
三位博士	[saam1 wai6 bok3 si6]the Magi/the Three Wise Kings from the East in the biblical nativity story
三俠五義	[saam1 hap6 ng5 ji6]Sanxia wuyi (lit. Three knight-errants and five righteous one), novel edited from stories of late Qing dynasty pinghua 評話|评话 master storyteller Shi Yukun 石玉昆
三個世界	[saam1 go3 sai3 gaai3]three worlds, i.e. Western capitalism, Soviet communism and the non-aligned countries
三個代表	[saam1 go3 doi6 biu2]the Three Represents enunciated by Jiang Zemin 江澤民|江泽民 as the duty of the Chinese Communist party in 2001, namely: to represent productivity of an advanced society, forward progress of advanced culture and the fundamental interests of the people
三個女人一臺戲	[saam1 go3 neoi5 jan4 jat1 toi4 hei3]three women are enough for a drama (idiom)
三倍	[saam1 pui5]triple
三催四請	[saam1 ceoi1 sei3 cing2]to coax and plead
三價	[saam1 gaa3]trivalent
三元區	[saam1 jyun4 keoi1]Sanyuan district of Sanming city 三明市[San1 ming2 shi4], Fujian
三元運算	[saam1 jyun4 wan6 syun3]ternary operator (computing)
三元醇	[saam1 jyun4 seon4]propyl alcohol C3H7OH
三光	[saam1 gwong1]the sun, the moon, and the stars
三光政策	[saam1 gwong1 zing3 caak3]Three Alls Policy (kill all, burn all, loot all), Japanese policy in China during WWII
三兩	[saam1 loeng5]two or three
三八線	[saam1 baat3 sin3]thirty eighth parallel, forming the DMZ border between North and South Korea
三公消費	[saam1 gung1 siu1 fai3]see 三公經費|三公经费[san1 gong1 jing1 fei4]
三公經費	[saam1 gung1 ging1 fai3]"three public expenditures" of the PRC government, i.e. air travel, food and entertainment, and public vehicles
三分	[saam1 fan1]somewhat/to some degree
三分之一	[saam1 fan1 zi1 jat1]one third
三分熟	[saam1 fan1 suk6]cooked three minutes/rare (of steak)
三包	[saam1 baau1]"three-guarantee service": repair, exchange, refund
三十	[saam1 sap6]thirty/30
三十二位元	[saam1 sap6 ji6 wai6 jyun4]32-bit (computing)
三十八度線	[saam1 sap6 baat3 dou6 sin3]thirty eighth parallel/dividing line agreed at Yalta between US and Soviet zones of influence in Korea, now the DMZ between North and South Korea
三十六字母	[saam1 sap6 luk6 zi6 mou5]thirty six initial consonants of Song phonetic theory
三十六計	[saam1 sap6 luk6 gai3]The Thirty-Six Stratagems, a Chinese essay used to illustrate a series of stratagems used in politics, war, and in civil interaction/all the possible schemes and stratagems
三十而立	[saam1 sap6 ji4 laap6]thirty years old and therefore independent (idiom, from Confucius)
三原	[saam1 jyun4]Sanyuan County in Xianyang 咸陽|咸阳[Xian2 yang2], Shaanxi
三原則	[saam1 jyun4 zak1]the Three Principles (in many contexts)
三原縣	[saam1 jyun4 jyun6]Sanyuan County in Xianyang 咸陽|咸阳[Xian2 yang2], Shaanxi
三叉戟	[saam1 caa1 gik1]trident
三叉神經	[saam1 caa1 san4 ging1]trigeminal nerve
三反	[saam1 faan2]"Three Anti" campaign (anti-corruption, anti-waste, anti-bureaucracy), early PRC purge of 1951-52
三反運動	[saam1 faan2 wan6 dung6]"Three Anti" campaign (anti-corruption, anti-waste, anti-bureaucracy), early PRC purge of 1951-52
三句話不離本行	[saam1 geoi3 waa6 bat1 lei4 bun2 hang4]to talk shop all the time (idiom)
三台	[saam1 toi4]Santai county in Mianyang 綿陽|绵阳[Mian2 yang2], north Sichuan
三台縣	[saam1 toi4 jyun6]Santai county in Mianyang 綿陽|绵阳[Mian2 yang2], north Sichuan
三合一	[saam1 hap6 jat1]three in one/triple
三合一疫苗	[saam1 hap6 jat1 jik6 miu4]DTP vaccination
三合土	[saam1 hap6 tou2]mortar/concrete/cement
三合星	[saam1 hap6 sing1]triple star system
三味線	[saam1 mei6 sin3]shamisen, three-stringed Japanese musical instrument
三和弦	[saam1 wo4 jin4]triad/musical chord of three notes, such as major triad do-mi-so
三國	[saam1 gwok3]Three Kingdoms period (220-280) in Chinese history/several Three Kingdoms periods in Korean history, esp. from 1st century AD to unification under Silla 新羅|新罗[Xin1 luo2] in 658
三國史記	[saam1 gwok3 si2 gei3]History of Three Kingdoms (Korean: Samguk Sagi), the oldest extant Korean history, compiled under Kim Busik 金富軾|金富轼[Jin1 Fu4 shi4] in 1145. The three kingdoms are Goguryeo 高句麗|高句丽[Gao1 gou1 li2], Baekje 百濟|百济[Bai3 ji4], Silla 新羅|新罗[Xin1 luo2].
三國志	[saam1 gwok3 zi3]History of the Three Kingdoms, fourth of the 24 dynastic histories 二十四史[Er4 shi2 si4 Shi3], composed by Chen Shou 陳壽|陈寿[Chen2 Shou4] in 289 during Jin Dynasty 晉朝|晋朝[Jin4 chao2], 65 scrolls
三國演義	[saam1 gwok3 jin2 ji6]Romance of the Three Kingdoms by Luo Guanzhong 羅貫中|罗贯中[Luo2 Guan4 zhong1], one of the Four Classic Novels of Chinese literature/a fictional account of the Three Kingdoms at the break-up of the Han around 200 AD, consistently portraying Liu Bei's Shu Han 劉備, 蜀漢|刘备, 蜀汉 as virtuous heroes and Cao Cao's Wei 曹操, 魏 as tyrannical villains
三圍	[saam1 wai4]BWH, abbr. for a woman's three measurements, namely: bust 胸圍|胸围[xiong1 wei2], waist 腰圍|腰围[yao1 wei2] and hip 臀圍|臀围[tun2 wei2]
三地門	[saam1 dei6 mun4]Santimen township in Pingtung County 屏東縣|屏东县[Ping2 dong1 Xian4], Taiwan
三地門鄉	[saam1 dei6 mun4 hoeng1]Santimen township in Pingtung County 屏東縣|屏东县[Ping2 dong1 Xian4], Taiwan
三大紀律八項注意	[saam1 daai6 gei2 leot6 baat3 hong6 zyu3 ji3]the Three Rules of Discipline and Eight Points for Attention, a military doctrine issued in 1928 by Mao Zedong for the Red Army, which included a number of injunctions demanding high standards of behavior and respect for civilians during wartime
三天兩頭	[saam1 tin1 loeng5 tau4]lit. twice every three days (idiom); practically every day/frequently
三夷教	[saam1 ji4 gaau3]the three foreign religions (Nestorianism, Manicheanism and Zoroastrianism)
三字經	[saam1 zi6 ging1]Three character classic, a 13th century reading primer consisting of Confucian tenets in lines of 3 characters
三字經	[saam1 zi6 ging1](slang) swearword/four-letter word
三官大帝	[saam1 gun1 daai6 dai3]the three gods in charge of heaven, earth and water (Daoism)
三家村	[saam1 gaa1 cyun1]lit. village of three households/name of essay column in Beijing newspaper from 1961-1966, written by Deng Tuo 鄧拓|邓拓, Wu Han 吳晗|吴晗 and Liao Mosha 廖沫沙, criticized as anti-party during the Cultural Revolution
三寶	[saam1 bou2]the Three Precious Treasures of Buddhism, namely: the Buddha 佛, the Dharma 法 (his teaching), and the Sangha 僧 (his monastic order)
三寶太監	[saam1 bou2 taai3 gaam1]Sanbao Eunuch, official title of Zheng He 鄭和|郑和[Zheng4 He2]/also written 三保太監|三保太监
三寸不爛之舌	[saam1 cyun3 bat1 laan6 zi1 sit6]to have a silver tongue/to have the gift of the gab
三對三鬥牛	[saam1 deoi3 saam1 dau3 ngau4]three-on-three basketball game
三尖杉酯鹼	[saam1 zim1 caam3 zi2 gaan2]harringtonine (chemistry)
三屜桌	[saam1 tai3 coek3]three-drawer desk (traditional Chinese piece of furniture)
三山	[saam1 saan1]Sanshan district of Wuhu city 蕪湖市|芜湖市[Wu2 hu2 shi4], Anhui
三山區	[saam1 saan1 keoi1]Sanshan district of Wuhu city 蕪湖市|芜湖市[Wu2 hu2 shi4], Anhui
三岔口	[saam1 caa3 hau2]At the Crossroads, famous opera, based on a story from 水滸傳|水浒传[Shui3 hu3 Zhuan4]
三島由紀夫	[saam1 dou2 jau4 gei2 fu1]Mishima Yukio (1925-1970), Japanese author, pen name of (平岡公威|平冈公威, Hiraoka Kimitake)
三峽	[saam1 haap6]Three Gorges on the Chang Jiang or Yangtze, namely: Qutang Gorge 瞿塘峽|瞿塘峡[Qu1 tang2 Xia2], Wuxia Gorge 巫峽|巫峡[Wu1 Xia2] and Xiling Gorge 西陵峽|西陵峡[Xi1 ling2 Xia2]/Sanxia or Sanhsia town in New Taipei City 新北市[Xin1 bei3 shi4], Taiwan
三峽大壩	[saam1 haap6 daai6 baa3]Three Gorges Dam on the Yangtze River
三峽水庫	[saam1 haap6 seoi2 fu3]Three gorges reservoir on the Changjiang or Yangtze
三峽鎮	[saam1 haap6 zan3]Sanxia or Sanhsia town in New Taipei City 新北市[Xin1 bei3 shi4], Taiwan
三度	[saam1 dou6]third (musical interval)
三廂	[saam1 soeng1]sedan (automobile body type)
三廢	[saam1 fai3]three types of waste product, namely: waste water 廢水|废水[fei4 shui3], exhaust gas 廢氣|废气[fei4 qi4], industrial slag 廢渣|废渣[fei4 zha1]
三弦	[saam1 jin4]sanxian, large family of 3-stringed plucked musical instruments, with snakeskin covered wooden soundbox and long neck, used in folk music, opera and Chinese orchestra
三得利	[saam1 dak1 lei6]Suntory, Japanese beverage company
三從四德	[saam1 cung4 sei3 dak1]Confucian moral injunctions for women, namely: obey in turn three men father, husband and son, plus the four virtues of morality 德, physical charm 容, propriety in speech 言 and efficiency in needlework 功
三心二意	[saam1 sam1 ji6 ji3]in two minds about sth (idiom)/half-hearted/shilly-shallying
三思而後行	[saam1 si1 ji4 hau6 hang4]think again and again before acting (idiom); consider carefully in advance
三思而行	[saam1 si1 ji4 hang4]think three times then go (idiom); don't act before you've thought it through carefully
三拗湯	[saam1 aau2 tong1]san'ao decoction (TCM)
三教	[saam1 gaau3]the Three Doctrines (Daoism, Confucianism, Buddhism)
三教九流	[saam1 gaau3 gau2 lau4]the Three Religions (Daoism, Confucianism, Buddhism) and Nine Schools (Confucians, Daoists, Yin-Yang, Legalists, Logicians, Mohists, Political Strategists, Eclectics, Agriculturists)/fig. people from all trades (often derog.)
三文治	[saam1 man4 zi6]sandwich (loanword)
三文魚	[saam1 man4 jyu4]salmon (loanword)
三族	[saam1 zuk6](old) three generations (father, self and sons)/three clans (your own, your mother's, your wife's)
三旬九食	[saam1 ceon4 gau2 sik6]lit. to have only nine meals in thirty days (idiom)/fig. (of a family) on the brink of starvation/in dire straits
三明	[saam1 ming4]Sanming prefecture level city in Fujian
三明市	[saam1 ming4 si5]Sanming prefecture level city in Fujian
三明治	[saam1 ming4 zi6]sandwich (loanword)
三星	[saam1 sing1]Sanxing or Sanhsing township in Yilan county 宜蘭縣|宜兰县[Yi2 lan2 xian4], Taiwan/Samsung (South Korean electronics company)
三星	[saam1 sing1]three major stars of the Three Stars 參宿|参宿[Shen1 xiu4] Chinese constellation/the belt of Orion/three spirits 福[fu2], 祿|禄[lu4], and 壽|寿[shou4] associated with the Three Stars 參宿|参宿[Shen1 xiu4] Chinese constellation
三星鄉	[saam1 sing1 hoeng1]Sanxing or Sanhsing township in Yilan county 宜蘭縣|宜兰县[Yi2 lan2 xian4], Taiwan
三星集團	[saam1 sing1 zaap6 tyun4]Samsung Group
三春	[saam1 ceon1]the three spring months
三昧	[saam1 mui6]Samadhi (Buddhist term)
三更半夜	[saam1 gang1 bun3 je6]in the depth of the night/very late at night
三曹	[saam1 cou4]the Three Caos (Cao Cao 曹操 and his sons Cao Pi 曹丕 and Cao Zhi 曹植), who established the Wei or Cao Wei dynasty 曹魏, and were all three noted poets and calligraphers
三月	[saam1 jyut6]March/third month (of the lunar year)
三月份	[saam1 jyut6 fan6]March
三月街	[saam1 jyut6 gaai1]Third Month Fair, traditional festival of the Bai Nationality 白族[Bai2 zu2]
三朋四友	[saam1 pang4 sei3 jau5]friends/cronies
三框欄	[saam1 hong1 laan4]name of radical in Chinese characters (Kangxi radical 22)/see also 匚[fang1]
三極管	[saam1 gik6 gun2]triode (vacuum tube or transistor)
三權分立	[saam1 kyun4 fan1 laap6]separation of powers
三次	[saam1 ci3]third/three times/(math.) degree three, cubic (equation)
三次冪	[saam1 ci3 mik6]cube (third power, math.)
三次方	[saam1 ci3 fong1]cube (third power, math.)
三次方程	[saam1 ci3 fong1 cing4]cubic equation (math.)
三次曲線	[saam1 ci3 kuk1 sin3]cubic curve (geometry)
三歸依	[saam1 gwai1 ji1]the Three Pillars of Faith (Buddha, dharma, sangha)/see also 三寶|三宝[san1 bao3]
三段論	[saam1 dyun6 leon6]syllogism (deduction in logic)
三毛貓	[saam1 mou4 maau1]tortoiseshell cat/calico cat
三民	[saam1 man4]Sanmin district of Kaohsiung city 高雄市[Gao1 xiong2 shi4], south Taiwan
三民主義	[saam1 man4 zyu2 ji6]Dr Sun Yat-sen's 孫中山|孙中山 Three principles of the people (late 1890s)
三民區	[saam1 man4 keoi1]Sanmin district of Kaohsiung city 高雄市[Gao1 xiong2 shi4], south Taiwan
三民鄉	[saam1 man4 hoeng1]Sanmin district of Kaohsiung city 高雄市[Gao1 xiong2 shi4], south Taiwan
三氟化硼	[saam1 fat1 faa3 paang4]boron trifluoride
三氯化磷	[saam1 luk6 faa3 leon4]phosphorous trichloride
三氯化鐵	[saam1 luk6 faa3 tit3]ferric chloride FeCl3
三氯已烯	[saam1 luk6 ji5 hei1]trichloroethylene
三氯氧磷	[saam1 luk6 joeng5 leon4]phosphorous oxychloride
三氯氰胺	[saam1 luk6 cing1 aat3]melamine C3H6N6
三水	[saam1 seoi2]Sanshui district of Foshan city 佛山市[Fo2 shan1 shi4], Guangdong
三水區	[saam1 seoi2 keoi1]Sanshui district of Foshan city 佛山市[Fo2 shan1 shi4], Guangdong
三水縣	[saam1 seoi2 jyun6]Sanshui county in Guangdong
三江並流	[saam1 gong1 bing6 lau4]Three Parallel Rivers National Park, in mountainous northwest Yunnan World Heritage protected area: the three rivers are Nujian 怒江 or Salween, Jinsha 金沙江 or upper reaches of Changjiang and Lancang 澜沧江 or Mekong
三江侗族自治縣	[saam1 gong1 tung4 zuk6 zi6 zi6 jyun6]Sanjiang Dong autonomous county in Liuzhou 柳州[Liu3 zhou1], Guangxi
三江平原	[saam1 gong1 ping4 jyun4]Sanjiang or Three rivers plain in Heilongjiang, vast wetland watered by Heilongjiang 黑龍江|黑龙江[Hei1 long2 jiang1] or Amur, Songhua 松花江[Song1 hua1 jiang1], Ussuri 烏蘇里江|乌苏里江[Wu1 su1 li3 jiang1]
三江源	[saam1 gong1 jyun4]Sanjiangyuan National Nature Reserve, high plateau region of Qinghai containing the headwaters of Changjiang or Yangtze, Huanghe or Yellow River and Lancang or Mekong River
三江生態旅遊區	[saam1 gong1 saang1 taai3 leoi5 jau4 keoi1]Sanjiang ecological tourist area in Wenchuan county 汶川县, northwest Sichuan
三河	[saam1 ho4]Three rivers/Sanhe county level city in Langfang 廊坊[Lang2 fang2], Hebei
三河市	[saam1 ho4 si5]Sanhe county level city in Langfang 廊坊[Lang2 fang2], Hebei
三河縣	[saam1 ho4 jyun6]Sanhe county in Beijing
三法司	[saam1 faat3 si1]Three judicial chief ministries in imperial China
三洋	[saam1 joeng4]Sanyō, Japanese electronics company
三流	[saam1 lau4]third-rate/inferior
三浦梅園	[saam1 pou2 mui4 jyun4]MIURA Baien (1723-1789), Japanese neo-Confucian philosopher and pioneer economist, author of The Origin of value 價原|价原[Jia4 yuan2]
三溫暖	[saam1 wan1 nyun5]sauna (loanword) (Tw)
三灣	[saam1 waan1]Sanwan township in Miaoli county 苗栗縣|苗栗县[Miao2 li4 xian4], northwest Taiwan
三灣鄉	[saam1 waan1 hoeng1]Sanwan township in Miaoli county 苗栗縣|苗栗县[Miao2 li4 xian4], northwest Taiwan
三焦	[saam1 ziu1]triple foci, the three visceral cavities (TCM)
三班倒	[saam1 baan1 dou2]three-shift system (work rostering)
三瓦兩舍	[saam1 ngaa5 loeng5 se3]places of pleasure (like brothels, tea houses etc)
三生有幸	[saam1 saang1 jau5 hang6]the blessing of three lifetimes (idiom)/(courteous language) it's my good fortune...
三用表	[saam1 jung6 biu2]instrument console (diving)
三田	[saam1 tin4]Mita, Sanda, Mitsuda etc (Japanese surname or place name)
三田	[saam1 tin4]3 annual hunting bouts/3 qi points
三略	[saam1 loek6]see 黃石公三略|黄石公三略[Huang2 Shi2 gong1 San1 lu:e4]
三番五次	[saam1 faan1 ng5 ci3]over and over again (idiom)
三疊紀	[saam1 dip6 gei2]Triassic (geological period 250-205m years ago)
三百六十行	[saam1 baak3 luk6 sap6 hang4]all walks of life (idiom)/every trade
三皇	[saam1 wong4]Three Sovereigns, between Gods and Emperors in third millennium BC/usually listed as Suiren 燧人[Sui4 ren2], Fuxi 伏羲[Fu2 Xi1], trapping and writing, Shennong or Farmer God 神農|神农[Shen2 nong2]
三皇五帝	[saam1 wong4 ng5 dai3]three sovereigns 三皇[san1 huang2] and five emperors 五帝[wu3 di4] of myth and legend/the earliest system of Chinese historiography
三皇炮捶	[saam1 wong4 paau3 ceoi4]Paochui - "Three Emperor Cannon Punch" (Chinese Martial Art)
三硝基甲苯	[saam1 siu1 gei1 gaap3 bun2]trinitrotoluene (TNT)
三碳糖	[saam1 taan3 tong4]triose (CH20)3, monosaccharide with three carbon atoms, such as glyceraldehyde 甘油醛[gan1 you2 quan2]
三秒膠	[saam1 miu5 gaau1]superglue
三稜草	[saam1 ling4 cou2]sedge herb (Cyperus rotundus)
三稜鏡	[saam1 ling4 geng3](triangular) prism
三穗	[saam1 seoi6]Sansui county in Qiandongnan Miao and Dong autonomous prefecture 黔東南州|黔东南州[Qian2 dong1 nan2 zhou1], Guizhou
三穗縣	[saam1 seoi6 jyun6]Sansui county in Qiandongnan Miao and Dong autonomous prefecture 黔東南州|黔东南州[Qian2 dong1 nan2 zhou1], Guizhou
三等分	[saam1 dang2 fan1]trisection (math.)/trisecting an angle
三等分角	[saam1 dang2 fan1 gok3]trisection (math.)/trisecting an angle
三級	[saam1 kap1]grade 3/third class/category C
三級士官	[saam1 kap1 si6 gun1]staff sergeant
三級片	[saam1 kap1 pin3]third category movie (containing sexual or violent content)
三級跳	[saam1 kap1 tiu3]triple jump (athletics)/hop, skip and jump
三級跳遠	[saam1 kap1 tiu3 jyun5]triple jump (athletics)/hop, skip and jump
三索錦蛇	[saam1 sok3 gam2 se4]copperhead race (Elaphe radiata), kind of snake
三維	[saam1 wai4]three dimensional/3D
三維空間	[saam1 wai4 hung1 gaan1]three-dimensional space/3D
三綱五常	[saam1 gong1 ng5 soeng4]three principles and five virtues (idiom)/the three rules (ruler guides subject, father guides son and husband guides wife) and five constant virtues of Confucianism (benevolence 仁, righteousness 義|义, propriety 禮|礼, wisdom 智 and fidelity 信)
三義	[saam1 ji6]Sanyi township in Miaoli county 苗栗縣|苗栗县[Miao2 li4 xian4], northwest Taiwan
三義鄉	[saam1 ji6 hoeng1]Sanyi township in Miaoli county 苗栗縣|苗栗县[Miao2 li4 xian4], northwest Taiwan
三聚氰胺	[saam1 zeoi6 cing1 aat3]melamine C3H6N6
三聯書店	[saam1 lyun4 syu1 dim3]Joint Publishing, book store chain and publisher, founded in Hong Kong in 1948
三聯管	[saam1 lyun4 gun2]triplet
三胚層動物	[saam1 pui1 cang4 dung6 mat6]triploblastic animals (having three germ layers)
三胞胎	[saam1 baau1 toi1]triplets
三腳兩步	[saam1 goek3 loeng5 bou6]hurriedly/just a few steps away
三腳架	[saam1 goek3 gaa3]tripod/derrick crane
三腳貓	[saam1 goek3 maau1]jack of all trades
三自	[saam1 zi6]abbr. for 三自愛國教會|三自爱国教会[San1 zi4 Ai4 guo2 Jiao4 hui4], Three-Self Patriotic Movement
三自愛國教會	[saam1 zi6 oi3 gwok3 gaau3 wui5]Three-Self Patriotic Movement, PRC government-sanctioned Protestant church from 1949
三自教會	[saam1 zi6 gaau3 wui5]Three-Self Patriotic Movement, PRC government-sanctioned Protestant church from 1949
三色	[saam1 sik1]three colors
三色堇	[saam1 sik1 gan2]pansy
三色紫羅蘭	[saam1 sik1 zi2 lo4 laan4]pansy
三色貓	[saam1 sik1 maau1]calico cat
三芝	[saam1 zi1]Sanzhi or Sanchih township in New Taipei City 新北市[Xin1 bei3 shi4], Taiwan
三芝鄉	[saam1 zi1 hoeng1]Sanzhi or Sanchih township in New Taipei City 新北市[Xin1 bei3 shi4], Taiwan
三茶六飯	[saam1 caa4 luk6 faan6]lit. to offer three kinds of tea and six different dishes/to be extremely considerate towards guests (idiom)
三菱	[saam1 ling4]Mitsubishi
三葉星雲	[saam1 jip6 sing1 wan4]Trifid Nebula M20
三葉草	[saam1 jip6 cou2]clover/trefoil
三葉蟲	[saam1 jip6 cung4]trilobite
三藏	[saam1 cong4]Tripitaka (602-664) Tang dynasty Buddhist monk and translator, who traveled to India 629-645/same as 玄奘
三藏法師	[saam1 cong4 faat3 si1]Tripitaka (602-664) Tang dynasty Buddhist monk and translator, who traveled to India 629-645/same as 玄奘
三藩之亂	[saam1 faan4 zi1 lyun6]Three feudatories rebellion against Qing 1673-1681 during the reign of Kangxi
三藩叛亂	[saam1 faan4 bun6 lyun6]rebellion against the Qing of 1670s, pacified by Kangxi
三藩市	[saam1 faan4 si5]San Francisco (California)
三蘇	[saam1 sou1]the Three Su father and sons/refers to northern Song literati Su Xun 蘇洵|苏洵, Su Shi 蘇軾|苏轼 and Su Zhe 蘇轍|苏辙
三號木桿	[saam1 hou6 muk6 gon1]spoon (golf)
三號電池	[saam1 hou6 din6 ci4]C size battery (PRC)/AA battery (Taiwan)/see 二號電池|二号电池 (C battery in Taiwan) and 五號電池|五号电池 (AA battery in PRC)
三親六故	[saam1 can1 luk6 gu3]old friends and relatives
三角	[saam1 gok3]triangle
三角債	[saam1 gok3 zaai3]chain of debt
三角凳	[saam1 gok3 dang3]trestle stool/folding chair
三角函數	[saam1 gok3 haam4 sou3]trigonometric function
三角學	[saam1 gok3 hok6]trigonometry
三角座	[saam1 gok3 zo6]Triangulum (constellation)
三角形	[saam1 gok3 jing4]triangle
三角恐龍	[saam1 gok3 hung2 lung4]triceratops (dinosaur)
三角戀愛	[saam1 gok3 lyun2 oi3]love triangle
三角板	[saam1 gok3 baan2]set square/triangle (for drawing right angles)
三角柱體	[saam1 gok3 cyu5 tai2]triangular prism (math.)
三角法	[saam1 gok3 faat3]trigonometry (math.)
三角洲	[saam1 gok3 zau1]delta (geography)
三角測量法	[saam1 gok3 cak1 loeng4 faat3]triangulation (surveying)
三角肌	[saam1 gok3 gei1]deltoid muscle (over the shoulder)
三角腹帶	[saam1 gok3 fuk1 daai3]athletic supporter
三角褲	[saam1 gok3 fu3]briefs/panties
三角褲衩	[saam1 gok3 fu3 caa3]briefs/panties
三角錐	[saam1 gok3 zeoi1]triangular pyramid (math.)
三角關係	[saam1 gok3 gwaan1 hai6]triangle relationship/a love triangle
三角龍	[saam1 gok3 lung4]triceratops
三言兩句	[saam1 jin4 loeng5 geoi3]in a few words (idiom); expressed succinctly
三言兩語	[saam1 jin4 loeng5 jyu5]in a few words (idiom); expressed succinctly
三論宗	[saam1 leon6 zung1]Three Treatise School (Buddhism)
三貂角	[saam1 diu1 gok3]Cape San Diego or Santiao, easternmost point of Taiwan Island
三資企業	[saam1 zi1 kei5 jip6]foreign, private and joint ventures
三足烏	[saam1 zuk1 wu1]three-legged Golden Crow that lives in the sun (in northeast Asian and Chinese mythology)/Korean: samjog'o
三足金烏	[saam1 zuk1 gam1 wu1]three-legged Golden Crow that lives in the sun (in northeast Asian and Chinese mythology)/Korean: samjog'o
三跪九叩	[saam1 gwai6 gau2 kau3]to kneel three times and kowtow nine times (formal etiquette on meeting the emperor)
三軍	[saam1 gwan1](in former times) upper, middle and lower army/army of right, center and left/(in modern times) the three armed services: Army, Navy and Air Force
三輪車	[saam1 leon4 ce1]pedicab/tricycle
三輪車夫	[saam1 leon4 ce1 fu1]pedicab driver
三農	[saam1 nung4]see 三農問題|三农问题[san1 nong2 wen4 ti2]
三農問題	[saam1 nung4 man6 tai4]the three rural issues: agriculture, rural areas and peasants
三迭紀	[saam1 dit6 gei2]Triassic (geological period 250-205m years ago)/also written 三疊紀|三叠纪
三退	[saam1 teoi3]withdrawal from the Communist Party, the Communist Youth League, and the Young Pioneers of China
三連勝	[saam1 lin4 sing3]hat-trick (sports)
三邊形	[saam1 bin1 jing4]triangle
三部曲	[saam1 bou6 kuk1]trilogy
三都水族自治縣	[saam1 dou1 seoi2 zuk6 zi6 zi6 jyun6]Sandu Shuizu autonomous county in Qiannan Buyei and Miao autonomous prefecture 黔南州[Qian2 nan2 zhou1], Guizhou
三都縣	[saam1 dou1 jyun6]Sandu Shuizu autonomous county in Qiannan Buyei and Miao autonomous prefecture 黔南州[Qian2 nan2 zhou1], Guizhou
三酸甘油酯	[saam1 syun1 gam1 jau4 zi2]triglyceride
三里屯	[saam1 lei5 tyun4]Sanlitun (Beijing street name)
三里河	[saam1 lei5 ho4]Sanlihe (Beijing street name)
三重	[saam1 cung5]Sanchong or Sanch'ung city in New Taipei City 新北市[Xin1 bei3 shi4], Taiwan/Mie Prefecture in central Japan
三重	[saam1 cung5]treble
三重奏	[saam1 cung5 zau3]trio (musical ensemble)
三重市	[saam1 cung5 si5]Sanchong or Sanch'ung city in New Taipei City 新北市[Xin1 bei3 shi4], Taiwan
三重縣	[saam1 cung5 jyun6]Mi'e prefecture in central Japan
三鍵	[saam1 gin6]triple bond (chemistry)/triple link
三門	[saam1 mun4]Sanmen county in Taizhou 台州[Tai2 zhou1], Zhejiang
三門峽	[saam1 mun4 haap6]Sanmenxia prefecture level city in Henan
三門峽市	[saam1 mun4 haap6 si5]Sanmenxia prefecture level city in Henan
三門縣	[saam1 mun4 jyun6]Sanmen county in Taizhou 台州[Tai2 zhou1], Zhejiang
三阿姨	[saam1 aa3 ji4]auntie, third eldest of sisters in mother's family
三陪小姐	[saam1 pui4 siu2 ze2]female escort/bar girl
三音	[saam1 jam1]third (musical interval, e.g. do-mi)
三音度	[saam1 jam1 dou6]third (musical interval)
三項	[saam1 hong6]three items/three events/three terms/tri-/trinomial, ternary (math.)/triathlon (abbr. for 三項全能|三项全能)
三項全能	[saam1 hong6 cyun4 nang4]triathlon
三項式	[saam1 hong6 sik1]trinomial (math.)
三頭六臂	[saam1 tau4 luk6 bei3]lit. to have three heads and six arms (idiom)/fig. to possess remarkable abilities/a being of formidable powers
三頭肌	[saam1 tau4 gei1]triceps muscle/triceps brachii
三顧茅廬	[saam1 gu3 maau4 lou4]lit. three humble visits to a thatched cottage/cf famous episode in the fictional Romance of Three Kingdoms 三國演義|三国演义 in which Liu Bei 劉備|刘备 recruits Zhuge Liang 諸葛亮|诸葛亮 (the Hidden Dragon 臥龍|卧龙) to his cause by visiting him three times
三馬同槽	[saam1 maa5 tung4 cou4]three horses at the same trough (idiom, alluding to Sima Yi 司馬懿|司马懿[Si1 ma3 Yi4] and his two sons); conspirators under the same roof
三駕馬車	[saam1 gaa3 maa5 ce1]troika
三體	[saam1 tai2]trisomy
三體問題	[saam1 tai2 man6 tai4]three-body problem (mechanics)
三魂	[saam1 wan4]three immortal souls in Daoism, representing spirit and intellect
三魂七魄	[saam1 wan4 cat1 paak3]three immortal souls and seven mortal forms in Daoism, contrasting the spiritual and carnal side of man
三鮮	[saam1 sin1]three fresh ingredients (in cooking)
三鹿	[saam1 luk6]Three Deer (brand)
三鹿集團	[saam1 luk6 zaap6 tyun4]Sanlu Group, Chinese state-owned dairy products company involved in the 2008 melamine poisoning scandal
三點水	[saam1 dim2 seoi2]name of "water" radical in Chinese characters (Kangxi radical 85)/see also 氵[shui3]
上一個	[soeng6 jat1 go3]previous one
上一號	[soeng6 jat1 hou6](coll.) to go pee/to go to the bathroom
上一頁	[soeng6 jat1 jip6]preceding page
上上之策	[soeng6 soeng6 zi1 caak3]the best policy/the best thing one can do in the circumstances
上下	[soeng6 haa6]up and down/top and bottom/old and new/length/about
上下五千年	[soeng6 haa6 ng5 cin1 nin4]popular history of China in three volumes by Cao Yuzhang 曹余章
上下其手	[soeng6 haa6 kei4 sau2]to raise and lower one's hand (idiom); to signal as conspiratorial hint/fig. conspiring to defraud
上下床	[soeng6 haa6 cong4]bunk bed
上下文	[soeng6 haa6 man4](textual) context
上下文菜單	[soeng6 haa6 man4 coi3 daan1]context menu (computing)
上下班	[soeng6 haa6 baan1]to start and finish work
上下班時間	[soeng6 haa6 baan1 si4 gaan1]rush hour
上乘	[soeng6 sing4]first-class/best quality/also pr. [shang4 sheng4]
上交	[soeng6 gaau1]to hand over to/to give to higher authority/to seek connections in high places
上代	[soeng6 doi6]previous generation
上任	[soeng6 jam6]to take office/previous (incumbent)/predecessor
上位概念	[soeng6 wai6 koi3 nim6]superordinate concept
上來	[soeng6 loi4]to come up/to approach/(verb complement indicating success)
上供	[soeng6 gung1]to make offerings (to gods or ancestors)/to offer gifts to superiors in order to win their favor
上個	[soeng6 go3]first (of two parts)/last (week etc)/previous/the above
上個星期	[soeng6 go3 sing1 kei4]last week
上個月	[soeng6 go3 jyut6]last month
上傳	[soeng6 cyun4]to upload
上前	[soeng6 cin4]to advance/to step forward
上升空間	[soeng6 sing1 hung1 gaan1]upside/potential to rise
上升趨勢	[soeng6 sing1 ceoi1 sai3]an upturn/an upward trend
上午	[soeng6 ng5]morning
上半	[soeng6 bun3]first half
上半夜	[soeng6 bun3 je6]first half of the night/time before midnight
上半天	[soeng6 bun3 tin1]morning
上半年	[soeng6 bun3 nin4]first half (of a year)
上半晌	[soeng6 bun3 hoeng2]forenoon/morning/a.m.
上半葉	[soeng6 bun3 jip6]the first half (of a period)
上半身	[soeng6 bun3 san1]the upper body
上半部分	[soeng6 bun3 bou6 fan1]upper part/top half
上去	[soeng6 heoi3]to go up
上口	[soeng6 hau2]to be able to read aloud fluently/to be suitable (easy enough) for reading aloud
上口齒	[soeng6 hau2 ci2]supraoral tooth
上古	[soeng6 gu2]the distant past/ancient times/antiquity/early historical times
上古漢語	[soeng6 gu2 hon3 jyu5]Old Chinese (linguistics)
上台	[soeng6 toi4]to rise to power (in politics)/to go on stage (in the theater)
上司	[soeng6 si1]boss/superior
上合	[soeng6 hap6]SCO (Shanghai Cooperation Organisation)/abbr. for 上海合作組織|上海合作组织[Shang4 hai3 He2 zuo4 Zu3 zhi1]
上合組織	[soeng6 hap6 zou2 zik1]Shanghai Cooperation Organisation (SCO)
上吊	[soeng6 diu3]to hang oneself
上同調	[soeng6 tung4 diu6]cohomology (invariant of a topological space in math.)
上吐下瀉	[soeng6 tou3 haa6 se3]to vomit and have diarrhea
上周	[soeng6 zau1]last week
上呼吸道感染	[soeng6 fu1 kap1 dou6 gam2 jim5]upper respiratory tract infection
上唇	[soeng6 seon4]upper lip
上回	[soeng6 wui4]last time/the previous time
上坡	[soeng6 bo1]uphill/upslope/to move upwards/to climb a slope
上坡段	[soeng6 bo1 dyun6]uphill section (of a race)
上坡路	[soeng6 bo1 lou6]uphill road/slope up/fig. upward trend/progress
上城區	[soeng6 sing4 keoi1]Shangcheng district of Hangzhou city 杭州市[Hang2 zhou1 shi4], Zhejiang
上域	[soeng6 wik6]codomain of a function (math.)
上報	[soeng6 bou3]to report to one's superiors/to appear in the news/to reply to a letter
上場	[soeng6 coeng4]on stage/to go on stage/to take the field
上墳	[soeng6 fan4]to sweep the tombs (of one's ancestors)/the Qingming festival
上外	[soeng6 ngoi6]abbr. for 上海外國語大學|上海外国语大学[Shang4 hai3 Wai4 guo2 yu3 Da4 xue2]
上夜	[soeng6 je6]to be on night duty
上天	[soeng6 tin1]Heaven/Providence/God/the day before/the sky above/to fly to the sky/to take off and fly into space/to die/to pass away
上天入地	[soeng6 tin1 jap6 dei6]lit. to go up to heaven or down to Hades; fig. whichever way, I don't care/to decide to go ahead without foreboding
上夸克	[soeng6 kwaa1 hak1]up quark (particle physics)
上好	[soeng6 hou2]first-rate/top-notch
上學	[soeng6 hok6]to go to school/to attend school
上官	[soeng6 gun1]two-character surname Shangguan
上官	[soeng6 gun1]high-ranking official/superior
上家	[soeng6 gaa1]preceding player (in a game)
上將	[soeng6 zoeng1]general/admiral/air chief marshal
上將軍	[soeng6 zoeng1 gwan1]top general/commander-in-chief
上層	[soeng6 cang4]upper layer
上層建築	[soeng6 cang4 gin3 zuk1]superstructure
上山	[soeng6 saan1]to go uphill/to spin cocoon (silkworms)/to pass away
上山下鄉	[soeng6 saan1 haa6 hoeng1]to work in the fields (esp. young school-leavers)/forced agricultural experience for city intellectuals
上崗	[soeng6 gong1]to take up one's post/to be given a job
上工	[soeng6 gung1]to go to work/to start work
上市	[soeng6 si5]to hit the market (of a new product)/to float (a company on the stock market)
上市公司	[soeng6 si5 gung1 si1]listed company
上帝	[soeng6 dai3]God
上座	[soeng6 zo6]seat of honor
上座部	[soeng6 zo6 bou6]Theravada, the primary Buddhism, as spread to Sri Lanka and South-East Asia
上弦	[soeng6 jin4]to wind/to tighten/crescent moon/first quarter or waxing moon
上弦月	[soeng6 jin4 jyut6]first quarter moon
上心	[soeng6 sam1]carefully/meticulously/to set one's heart on sth
上思	[soeng6 si1]Shangxi county in Fangchenggang 防城港[Fang2 cheng2 gang3], Guangxi
上思縣	[soeng6 si1 jyun6]Shangxi county in Fangchenggang 防城港[Fang2 cheng2 gang3], Guangxi
上房	[soeng6 fong4]see 正房[zheng4 fang2]
上手	[soeng6 sau2]to obtain/to master/overhand (serve etc)/seat of honor
上揚	[soeng6 joeng4]to rise (i.e. number increases)/a price rise/to raise
上揚趨勢	[soeng6 joeng4 ceoi1 sai3]upward trend/rising tendency
上文	[soeng6 man4]preceding part of the text
上新世	[soeng6 san1 sai3]Pliocene (geological epoch from 5m-2m years ago)
上方寶劍	[soeng6 fong1 bou2 gim3]imperial sword (giving bearer plenipotentiary powers)/imperial Chinese version of 007 licensed to kill
上旬	[soeng6 ceon4]first third of a month
上昇	[soeng6 sing1]to rise/to go up/to ascend
上星	[soeng6 sing1]to broadcast through satellite/satellite (TV etc)/shangxing acupoint (DU23)
上星期	[soeng6 sing1 kei4]last week/previous week
上映	[soeng6 jing2]to show (a movie)/to screen
上書	[soeng6 syu1]to write a letter (to the authorities)/to present a petition
上月	[soeng6 jyut6]last month
上有老下有小	[soeng6 jau5 lou5 haa6 jau5 siu2]lit. above are the elderly, below are the young (idiom)/fig. to have to take care of both one's aging parents and one's children/sandwich generation
上杭	[soeng6 hong4]Shanghang county level city in Longyan 龍岩|龙岩, Fujian
上杭縣	[soeng6 hong4 jyun6]Shanghang county in Longyan 龍岩|龙岩, Fujian
上林	[soeng6 lam4]Shanglin county in Nanning 南寧|南宁[Nan2 ning2], Guangxi
上林縣	[soeng6 lam4 jyun6]Shanglin county in Nanning 南寧|南宁[Nan2 ning2], Guangxi
上栗	[soeng6 leot6]Shangli county in Pingxiang 萍鄉|萍乡, Jiangxi
上栗縣	[soeng6 leot6 jyun6]Shangli county in Pingxiang 萍鄉|萍乡, Jiangxi
上校	[soeng6 haau6]high ranking officer in Chinese army/colonel
上桿	[soeng6 gon1]backswing (golf)
上梁不正下梁歪	[soeng6 loeng4 bat1 zing3 haa6 loeng4 waai1]lit. If the upper beam is not straight, the lower beam will be crooked (idiom); fig. subordinates imitate their superiors' vices
上樓	[soeng6 lau4]to go upstairs
上標	[soeng6 biu1]superscript
上次	[soeng6 ci3]last time
上款	[soeng6 fun2]addressee/name of recipient on painting or scroll
上氣不接下氣	[soeng6 hei3 bat1 zip3 haa6 hei3]not enough breath (idiom); to gasp for breath
上水	[soeng6 seoi2]Sheung Shui (area in Hong Kong)
上汽	[soeng6 hei3]abbr. for 上海汽車工業集團|上海汽车工业集团, Shanghai Automotive Industry Corp. (SAIC)
上流	[soeng6 lau4]upper class
上浣	[soeng6 wun5]first ten days of a lunar month
上浮	[soeng6 fau4]to float up
上海	[soeng6 hoi2]Shanghai municipality, central east China, abbr. to 滬|沪[Hu4]
上海交通大學	[soeng6 hoi2 gaau1 tung1 daai6 hok6]Shanghai Jiao Tong University
上海合作組織	[soeng6 hoi2 hap6 zok3 zou2 zik1]Shanghai Cooperation Organisation (SCO)
上海商務印書館	[soeng6 hoi2 soeng1 mou6 jan3 syu1 gun2]Commercial Press, Shanghai (from 1897)
上海外國語大學	[soeng6 hoi2 ngoi6 gwok3 jyu5 daai6 hok6]Shanghai International Studies University (SISU)
上海大劇院	[soeng6 hoi2 daai6 kek6 jyun2]Shanghai Grand Theater
上海大學	[soeng6 hoi2 daai6 hok6]Shanghai University
上海寶鋼集團公司	[soeng6 hoi2 bou2 gong3 zaap6 tyun4 gung1 si1]Baosteel
上海市	[soeng6 hoi2 si5]Shanghai municipality in southeast China, abbr. 滬|沪
上海戲劇學院	[soeng6 hoi2 hei3 kek6 hok6 jyun2]Shanghai Theatrical Institute
上海振華港口機械	[soeng6 hoi2 zan3 waa4 gong2 hau2 gei1 haai6]Shanghai Zhenhua Port Machinery Company
上海文廣新聞傳媒集團	[soeng6 hoi2 man4 gwong2 san1 man4 cyun4 mui4 zaap6 tyun4]Shanghai Media Group
上海汽車工業	[soeng6 hoi2 hei3 ce1 gung1 jip6]Shanghai Automotive Industry Corp. (SAIC)
上海汽車工業集團	[soeng6 hoi2 hei3 ce1 gung1 jip6 zaap6 tyun4]Shanghai Automotive Industry Corp. (SAIC)
上海浦東發展銀行	[soeng6 hoi2 pou2 dung1 faat3 zin2 ngan4 hang4]Shanghai Pudong Development Bank
上海環球金融中心	[soeng6 hoi2 waan4 kau4 gam1 jung4 zung1 sam1]Shanghai World Financial Center (SWFC), skyscraper
上海白菜	[soeng6 hoi2 baak6 coi3]baby bok choy/Shanghai bok choy
上海第二醫科大學	[soeng6 hoi2 dai6 ji6 ji1 fo1 daai6 hok6]Shanghai Second Medical University
上海話	[soeng6 hoi2 waa6]Shanghainese/Shanghai dialect
上海證券交易所	[soeng6 hoi2 zing3 hyun3 gaau1 ji6 so2]Shanghai Stock Exchange (SSE)
上海證券交易所綜合股價指	[soeng6 hoi2 zing3 hyun3 gaau1 ji6 so2 zung3 hap6 gu2 gaa3 zi2]Shanghai Stock Exchange (SSE) Composite Index
上海財經大學	[soeng6 hoi2 coi4 ging1 daai6 hok6]Shanghai University of Finance and Economics (SUFE)
上海醫科大學	[soeng6 hoi2 ji1 fo1 daai6 hok6]Shanghai Medical University
上海音樂學院	[soeng6 hoi2 jam1 lok6 hok6 jyun2]Shanghai Conservatory of Music
上海體育場	[soeng6 hoi2 tai2 juk6 coeng4]Shanghai Stadium
上游	[soeng6 jau4]upper reaches (of a river)/upper level/upper echelon/upstream
上溜油	[soeng6 lau4 jau4]basted (of meat etc)
上演	[soeng6 jin2]to screen (a movie)/to stage (a play)/a screening/a staging
上漲	[soeng6 zoeng3]to rise/to go up
上火	[soeng6 fo2]to get angry/to suffer from excessive internal heat (TCM)
上猶	[soeng6 jau4]Shangyou county in Ganzhou 贛州|赣州, Jiangxi
上猶縣	[soeng6 jau4 jyun6]Shangyou county in Ganzhou 贛州|赣州, Jiangxi
上班	[soeng6 baan1]to go to work/to be on duty/to start work/to go to the office
上班族	[soeng6 baan1 zuk6]office workers (as social group)
上班時間	[soeng6 baan1 si4 gaan1]time of going to work/the morning rush hour
上環	[soeng6 waan4](coll.) to wear an intrauterine device (IUD)
上甘嶺	[soeng6 gam1 ling5]Shanganling district of Yichun city 伊春市[Yi1 chun1 shi4], Heilongjiang
上甘嶺區	[soeng6 gam1 ling5 keoi1]Shanganling district of Yichun city 伊春市[Yi1 chun1 shi4], Heilongjiang
上界	[soeng6 gaai3]upper bound
上疏	[soeng6 so1](of a court official) to present a memorial to the emperor (old)
上皮	[soeng6 pei4]epithelium
上確界	[soeng6 kok3 gaai3]supremum (math.)/least upper bound
上空	[soeng6 hung1]overhead/in the sky
上空洗車	[soeng6 hung1 sai2 ce1]topless car wash
上等	[soeng6 dang2]highest quality/top-notch
上等兵	[soeng6 dang2 bing1]private first class (army rank)
上箭頭	[soeng6 zin3 tau4]up-pointing arrow
上箭頭鍵	[soeng6 zin3 tau4 gin6]up arrow key (on keyboard)
上級	[soeng6 kap1]higher authorities/superiors
上級領導	[soeng6 kap1 ling5 dou6]high level leadership/top brass
上綱上線	[soeng6 gong1 soeng6 sin3]to criticize (as a matter of principle)
上網	[soeng6 mong5]to be on the Internet/to stretch a net (in a sports game or for covering sth)/to be netted (of fish)
上網本	[soeng6 mong5 bun2]netbook
上線	[soeng6 sin3]to go online/to put sth online
上繳	[soeng6 giu2]to transfer (income, profits etc) to higher authorities
上聲	[soeng6 sing1]falling and rising tone/third tone in modern Mandarin
上肢	[soeng6 zi1]upper limb
上膛	[soeng6 tong4]roof of the mouth/to load (a gun)
上船	[soeng6 syun4]to get on the boat
上色	[soeng6 sik1]top-quality/top-grade
上色	[soeng6 sik1]to color (a picture etc)/to dye (fabric etc)/to stain (furniture etc)
上艾瑟爾	[soeng6 ngaai6 sat1 ji5]Overijssel
上萬	[soeng6 maan6]over ten thousand/fig. untold numbers/innumerable/thousands upon thousands
上蒼	[soeng6 cong1]heaven
上蔡	[soeng6 coi3]Shangcai county in Zhumadian 駐馬店|驻马店[Zhu4 ma3 dian4], Henan
上蔡縣	[soeng6 coi3 jyun6]Shangcai county in Zhumadian 駐馬店|驻马店[Zhu4 ma3 dian4], Henan
上虞	[soeng6 jyu4]Shangyu county level city in Shaoxing 紹興|绍兴[Shao4 xing1], Zhejiang
上虞市	[soeng6 jyu4 si5]Shangyu county level city in Shaoxing 紹興|绍兴[Shao4 xing1], Zhejiang
上行	[soeng6 hang4](of trains) up (i.e. towards the capital)/(of river boats) to go against the current/to submit (a document) to higher authorities
上行下傚	[soeng6 hang4 haa6 haau6]subordinates follow the example of their superiors (idiom)
上街	[soeng6 gaai1]to go onto the streets/to go shopping
上街區	[soeng6 gaai1 keoi1]Shangjie District of Zhengzhou City 鄭州市|郑州市[Zheng4 zhou1 Shi4], Henan
上衣	[soeng6 ji1]jacket/upper outer garment
上衫	[soeng6 saam1]blouse
上裝	[soeng6 zong1]upper garment
上西天	[soeng6 sai1 tin1]to enter heaven/to rise to the Western Paradise
上覆	[soeng6 fuk1]to inform
上訪	[soeng6 fong2]to seek an audience with higher-ups (esp. government officials) to petition for sth
上訴	[soeng6 sou3]to appeal (a judicial case)/appeal
上訴法院	[soeng6 sou3 faat3 jyun2]appeal
上課	[soeng6 fo3]to go to class/to attend class/to go to teach a class
上調	[soeng6 diu6]to raise (prices)/to adjust upwards
上諭	[soeng6 jyu6]imperial edict/see also 聖諭|圣谕[sheng4 yu4]
上證	[soeng6 zing3]Shanghai Stock Exchange (SSE), abbr. for 上海證券交易所|上海证券交易所[Shang4 hai3 Zheng4 quan4 Jiao1 yi4 suo3]
上證綜合指數	[soeng6 zing3 zung3 hap6 zi2 sou3]SSE (Shanghai Stock Exchange) Composite Index
上議院	[soeng6 ji5 jyun2]Upper Chamber/Upper House/Senate
上身	[soeng6 san1]upper part of the body
上車	[soeng6 ce1]to get on or into (a bus, train, car etc)
上軌道	[soeng6 gwai2 dou6]to stay on track/to proceed smoothly
上載	[soeng6 zoi3]to upload
上輩	[soeng6 bui3]ancestors/one's elders
上輩子	[soeng6 bui3 zi2]one's ancestors/past generations/a former incarnation
上農	[soeng6 nung4]a rich farmer/to stress the importance of agriculture (in ancient philosophy)
上述	[soeng6 seot6]aforementioned/above-mentioned
上進	[soeng6 zeon3]to make progress/to do better/fig. ambitious to improve oneself/to move forwards
上進心	[soeng6 zeon3 sam1]motivation/ambition
上邊兒	[soeng6 bin1 ji4]erhua variant of 上邊|上边[shang4 bian5]
上部	[soeng6 bou6]upper section
上都	[soeng6 dou1]Shangdu, also known as Xanadu, summer capital of the Yuan Dynasty (1279-1368)
上野	[soeng6 je5]Ueno, Tokyo
上鉤	[soeng6 ngau1]to take the bait
上鉤兒	[soeng6 ngau1 ji4]erhua variant of 上鉤|上钩[shang4 gou1]
上鏡	[soeng6 geng3]photogenic/to appear on film or in the media
上門	[soeng6 mun4]to drop in/to visit/to lock a door/(of a shop) to close
上門費	[soeng6 mun4 fai3]house call fee/callout fee
上限	[soeng6 haan6]upper bound
上陣	[soeng6 zan6]to go into battle
上陣殺敵	[soeng6 zan6 saat3 dik6]to go into battle and kill the enemy/to fight
上鞋	[soeng6 haai4]to sole a shoe
上頁	[soeng6 jip6]previous page
上顎正門齒	[soeng6 ngok6 zing3 mun4 ci2]maxillary central incisor
上風	[soeng6 fung1]on the up/currently winning/rising (in popularity etc)
上饒	[soeng6 jiu4]Shangrao prefecture level city and county in Jiangxi
上饒地區	[soeng6 jiu4 dei6 keoi1]Shangrao prefecture in Jiangxi
上饒市	[soeng6 jiu4 si5]Shangrao prefecture level city in Jiangxi
上饒縣	[soeng6 jiu4 jyun6]Shangrao county in Shangrao 上饒|上饶, Jiangxi
上首	[soeng6 sau2]seat of honor/first place
上高	[soeng6 gou1]Shanggao county in Yichun 宜春, Jiangxi
上高縣	[soeng6 gou1 jyun6]Shanggao county in Yichun 宜春, Jiangxi
上齒	[soeng6 ci2]upper teeth
上齒齦	[soeng6 ci2 ngan4]upper alveolar ridge
上龍	[soeng6 lung4]pliosaurus
下一代	[haa6 jat1 doi6]the next generation
下一個	[haa6 jat1 go3]the next one
下一次	[haa6 jat1 ci3]next
下一步	[haa6 jat1 bou6]the next step
下一站	[haa6 jat1 zaam6]the next stop (of a bus etc)
下一頁	[haa6 jat1 jip6]next page
下不來	[haa6 bat1 loi4]awkward/embarrassed/cannot be accomplished
下不來臺	[haa6 bat1 loi4 toi4]to be put on the spot/to find oneself in an awkward situation
下不為例	[haa6 bat1 wai4 lai6]not to be repeated/not to be taken as a precedent/just this once
下世	[haa6 sai3]to die/future incarnation/next life/to be born/to come into the world/future generation
下令	[haa6 ling6]to give an order/to command
下任	[haa6 jam6]next office holder/next to serve
下來	[haa6 loi4]to come down/(after verb of motion, indicates motion down and towards us, also fig.)/(indicates continuation from the past towards us)/to be harvested (of crops)/to be over (of a period of time)/to go among the masses (said of leaders)
下修	[haa6 sau1]to revise downward
下個星期	[haa6 go3 sing1 kei4]next week
下個月	[haa6 go3 jyut6]next month
下凡	[haa6 faan4]to descend to the world (of immortals)
下列	[haa6 lit6]following
下劃線	[haa6 waak6 sin3]underscore _/underline
下功夫	[haa6 gung1 fu1]see 下工夫[xia4 gong1 fu5]
下午	[haa6 ng5]afternoon
下半	[haa6 bun3]second half
下半天	[haa6 bun3 tin1]afternoon
下半年	[haa6 bun3 nin4]second half of the year
下半身	[haa6 bun3 san1]lower half of one's body
下去	[haa6 heoi3]to go down/to descend/to go on/to continue/(of a servant) to withdraw
下唇	[haa6 seon4]lower lip
下單	[haa6 daan1]to place an order/to order/an order (of goods)
下回	[haa6 wui4]next chapter/next time
下坡	[haa6 bo1]downhill
下坡路	[haa6 bo1 lou6]downhill road/slope down/fig. to go downhill/on the decline
下垂	[haa6 seoi4]to droop/to sag/to hang down/sagging/drooping/prolapse (medicine)
下城區	[haa6 sing4 keoi1]Xiacheng district of Hangzhou city 杭州市[Hang2 zhou1 shi4], Zhejiang
下場	[haa6 coeng4]to leave (the stage, an exam room, the playing field etc)/to take part in some activity/to take an examination (in the imperial examination system)
下場	[haa6 coeng4]the end/to conclude
下場門	[haa6 coeng4 mun4]exit door (of the stage)
下夸克	[haa6 kwaa1 hak1]down quark (particle physics)
下定決心	[haa6 ding6 kyut3 sam1]to make a firm resolution
下定義	[haa6 ding6 ji6]to define
下家	[haa6 gaa1]player whose turn comes next (in a game)/next one/my humble home
下寒武	[haa6 hon4 mou5]lower Cambrian (geological period approx 530 million years ago)
下寒武統	[haa6 hon4 mou5 tung2]lower Cambrian series (geological strata from approx 530 million years ago)
下屆	[haa6 gaai3]next office holder/next to serve
下層	[haa6 cang4]underlayer/lower class/lower strata/substrate
下屬	[haa6 suk6]subordinate/underling
下屬公司	[haa6 suk6 gung1 si1]subsidiary (company)
下山	[haa6 saan1](of the sun) to set
下崗	[haa6 gong1]to come off sentry duty/to lay off (a worker)/laid-off
下崽	[haa6 zoi2](of animals) to give birth/to foal, to whelp etc
下工夫	[haa6 gung1 fu1]to put in time and energy/to concentrate one's efforts
下巴	[haa6 baa1]chin
下廚	[haa6 cyu4]to go to the kitchen (to prepare a meal)/to cook
下弦	[haa6 jin4]third quarter or waning moon
下弦月	[haa6 jin4 jyut6]third quarter or waning moon
下情	[haa6 cing4]feelings of the masses/my situation (humble speech)
下意識	[haa6 ji3 sik1]subconscious mind
下手	[haa6 sau2]to start/to put one's hand to/to set about/the seat to the right of the main guest
下拜	[haa6 baai3]to bow down low/to make obeisance/to kneel and bow
下挫	[haa6 co3](of sales, prices etc) to fall/to drop/decline/slump
下擺	[haa6 baai2]hem of a skirt/shirt tail
下放	[haa6 fong3]to delegate/to decentralize/to demote a party cadre to work on the shop floor or in the countryside
下方	[haa6 fong1]underneath/below/the underside/world of mortals/to descend to the world of mortals (of Gods)
下旋	[haa6 syun4](sport) backspin
下旋削球	[haa6 syun4 soek3 kau4](golf, tennis) undercut
下旬	[haa6 ceon4]last third of the month
下星期	[haa6 sing1 kei4]next week
下月	[haa6 jyut6]next month
下架	[haa6 gaa3]to take down from the shelves (e.g. a contaminated product)
下棋	[haa6 kei4]to play chess
下榻	[haa6 taap3]to stay (at a hotel etc during a trip)
下標	[haa6 biu1]subscript/suffix/index
下檻	[haa6 laam6]doorsill
下次	[haa6 ci3]next time
下款	[haa6 fun2]signature on letter/name of donor
下死勁	[haa6 sei2 ging6]to do one's utmost
下毒	[haa6 duk6]to put poison in sth/to poison
下水	[haa6 seoi2]downstream/to go into the water/to put into water/to launch (a ship)/fig. to fall into bad ways/to lead astray/to go to pot
下水	[haa6 seoi2]offal/viscera/tripe
下水禮	[haa6 seoi2 lai5]launching ceremony
下水管	[haa6 seoi2 gun2]drainpipe
下水道	[haa6 seoi2 dou6]sewer
下決心	[haa6 kyut3 sam1]to determine/to resolve
下沉	[haa6 cam4]to sink down
下注	[haa6 zyu3]to pour/to pour down (of rain)/to lay a bet
下流	[haa6 lau4]lower course of a river/low-class/mean and lowly/vulgar/obscene
下浣	[haa6 wun5]last ten days of the lunar month
下浮	[haa6 fau4]downward fluctuation (of prices etc)
下游	[haa6 jau4]lower reaches (of a river)/lower level/lower echelon/downstream
下滑	[haa6 waat6]sliding/slide
下營	[haa6 jing4]Hsiaying township in Tainan county 台南縣|台南县[Tai2 nan2 xian4], Taiwan
下營鄉	[haa6 jing4 hoeng1]Hsiaying township in Tainan county 台南縣|台南县[Tai2 nan2 xian4], Taiwan
下片	[haa6 pin3]to stop screening a movie/to end the run of a movie
下獄	[haa6 juk6]to imprison
下班	[haa6 baan1]to finish work/to get off work
下界	[haa6 gaai3]lower bound (math.)/world of mortals/(of Gods) to descend to the world of mortals
下畫線	[haa6 waak6 sin3]underline
下確界	[haa6 kok3 gaai3]infimum (math.)/greatest lower bound
下筆	[haa6 bat1]to put pen to paper
下箭頭	[haa6 zin3 tau4]down-pointing arrow
下箭頭鍵	[haa6 zin3 tau4 gin6]down arrow key (on keyboard)
下級	[haa6 kap1]low ranking/low level/underclass/subordinate
下網	[haa6 mong5]to cast a fishing net/(computing) to go offline
下線	[haa6 sin3]to go offline
下線儀式	[haa6 sin3 ji4 sik1]inauguration/tape-cutting to inaugurate a project/an unveiling ceremony
下而上	[haa6 ji4 soeng6]bottom to top (of listing)
下聘	[haa6 ping3]to send the betrothal gifts/(fig.) to conclude a marriage
下肢	[haa6 zi1]lower limbs
下腳料	[haa6 goek3 liu6]remnants of material from an industrial process/offcut/scraps
下腹部	[haa6 fuk1 bou6]lower abdomen
下至上	[haa6 zi3 soeng6]bottom to top
下臺	[haa6 toi4]to go off the stage/to fall from position of prestige/to step down (from office etc)/to disentangle oneself/to get off the hook
下臺階	[haa6 toi4 gaai1]to extricate oneself/way out
下花園	[haa6 faa1 jyun4]Xiahua district of Zhangjiakou city 張家口市|张家口市[Zhang1 jia1 kou3 shi4], Hebei
下花園區	[haa6 faa1 jyun4 keoi1]Xiahua district of Zhangjiakou city 張家口市|张家口市[Zhang1 jia1 kou3 shi4], Hebei
下落	[haa6 lok6]whereabouts/to drop/to fall
下落不明	[haa6 lok6 bat1 ming4]unaccounted/unknown whereabouts
下葬	[haa6 zong3]to bury/to inter
下蛋	[haa6 daan6]to lay eggs
下行	[haa6 hang4](of trains) down (i.e. away from the capital)/(of river boats) to travel downstream/to issue (a document) to lower bureaucratic levels/(of writing on the page) vertical, proceeding from top to bottom
下裝	[haa6 zong1]to take off costume and makeup
下西洋	[haa6 sai1 joeng4]to sail West (from China)/refers to Zhenghe's 15th century expeditions to the Western Pacific
下課	[haa6 fo3]to finish class/to get out of class
下調	[haa6 diu6]to demote/to pass down to a lower unit
下調	[haa6 diu6]to adjust downwards/to lower (prices, wages etc)
下議院	[haa6 ji5 jyun2]lower chamber (of legislative body)/lower house/the House of Commons
下議院議員	[haa6 ji5 jyun2 ji5 jyun4]Member of Parliament (MP) (UK Politics)
下跌	[haa6 dit3]to fall/to tumble
下跪	[haa6 gwai6]to kneel/to go down on one's knees
下身	[haa6 san1]lower part of the body/genitalia/trousers
下車	[haa6 ce1]to get off or out of (a bus, train, car etc)
下載	[haa6 zoi3]to download/also pr. [xia4 zai4]
下輩	[haa6 bui3]offspring/future generations/younger generation of a family/junior members of a group
下輩子	[haa6 bui3 zi2]the next life
下轄	[haa6 hat6]administered by/under the rule of
下週	[haa6 zau1]next week
下達	[haa6 daat6]to transmit down (a chain of command)/to pass down (to lower level)/to issue/to send through
下邊	[haa6 bin1]under/the underside/below
下邊兒	[haa6 bin1 ji4]erhua variant of 下邊|下边[xia4 bian5]
下鄉	[haa6 hoeng1]to go to the countryside
下酒	[haa6 zau2]to be appropriate to have with alcohol/to down one's drink
下酒菜	[haa6 zau2 coi3]a dish that goes well with alcoholic drinks
下野	[haa6 je5]to step down from office/to go into opposition
下錨	[haa6 naau4]to drop anchor
下閘	[haa6 zaap6]lower sluice gate/outflow sluice
下關	[haa6 gwaan1]Xiaguan district of Nanjing City 南京市 in Jiangsu 江蘇|江苏
下關區	[haa6 gwaan1 keoi1]Xiaguan district of Nanjing City 南京市 in Jiangsu 江蘇|江苏
下關市	[haa6 gwaan1 si5]Shimonoseki (Japan)
下降	[haa6 hong4]to decline/to drop/to fall/to go down/to decrease
下院	[haa6 jyun2]lower house (of parliament)
下陷	[haa6 haam6]to subside/subsidence
下陸	[haa6 luk6]Xialu district of Huangshi city 黃石市|黄石市[Huang2 shi2 shi4], Hubei
下陸區	[haa6 luk6 keoi1]Xialu district of Huangshi city 黃石市|黄石市[Huang2 shi2 shi4], Hubei
下雨	[haa6 jyu5]to rain
下雪	[haa6 syut3]to snow
下面	[haa6 min6]below/under/next/the following
下面請看	[haa6 min6 cing2 hon3]please see below
下頁	[haa6 jip6]next page
下顎	[haa6 ngok6]mandible (lower jaw)
下風	[haa6 fung1]leeward/downwind/disadvantageous position/to concede or give way in an argument
下風方向	[haa6 fung1 fong1 hoeng3]leeward
下飛機	[haa6 fei1 gei1]to get off a plane/to deplane
下馬	[haa6 maa5]to dismount from a horse/(fig.) to abandon (a project)
下體	[haa6 tai2]lower body/euphemism for genitals/root and stem of plants
下鼻甲	[haa6 bei6 gaap3]inferior nasal conchae
下齒	[haa6 ci2]bottom teeth
下龍灣	[haa6 lung4 waan1]Ha Long Bay, Vietnam
不一	[bat1 jat1]to vary/to differ
不一定	[bat1 jat1 ding6]not necessarily/maybe
不一會	[bat1 jat1 wui5]soon
不一樣	[bat1 jat1 joeng6]different/distinctive/unlike
不一而足	[bat1 jat1 ji4 zuk1]by no means an isolated case/numerous
不一致字	[bat1 jat1 zi3 zi6]inconsistent phonogram(s)
不三不四	[bat1 saam1 bat1 sei3]dubious/shady/neither one thing nor the other/neither fish nor fowl/nondescript
不下	[bat1 haa6]to be not less than (a certain quantity, amount etc)
不下于	[bat1 haa6 jyu1]as many as/no less than/not inferior to/as good as/on a par with
不中意	[bat1 zung1 ji3]not to one's liking
不中用	[bat1 zung1 jung6]unfit for anything/no good/useless
不丹	[bat1 daan1]Bhutan
不主故常	[bat1 zyu2 gu3 soeng4]not to stick to the old conventions
不久	[bat1 gau2]not long (after)/before too long/soon/soon after
不久前	[bat1 gau2 cin4]not long ago
不乏	[bat1 fat6]there is no lack of
不乾不淨	[bat1 gon1 bat1 zing6]unclean/filthy/foul-mouthed
不了	[bat1 liu5]unable to/without end
不了了之	[bat1 liu5 liu5 zi1]to settle a matter by leaving it unsettled/to end up with nothing definite
不事生產	[bat1 si6 saang1 caan2]not to do anything productive/to idle away one's time
不二價	[bat1 ji6 gaa3]one price for all/fixed price
不二法門	[bat1 ji6 faat3 mun4]the one and only way/the only proper course to take
不亞	[bat1 aa3]no less than/not inferior to
不亞於	[bat1 aa3 jyu1]no less than/not inferior to
不亢不卑	[bat1 kong3 bat1 bei1]neither haughty nor humble/neither overbearing nor servile/neither supercilious nor obsequious
不亦樂乎	[bat1 jik6 lok6 fu4]lit. isn't that a joy? (quote from Confucius)/fig. (jocularly) extremely/awfully
不人道	[bat1 jan4 dou6]inhuman
不仁	[bat1 jan4]not benevolent/heartless/numb
不令人鼓舞	[bat1 ling6 jan4 gu2 mou5]discouraging/disheartening
不以人廢言	[bat1 ji5 jan4 fai3 jin4]not to reject a word because of the speaker (idiom, from Analects); to judge on the merits of the case rather than preference between advisers
不以為然	[bat1 ji5 wai4 jin4]not to accept as correct (idiom); to object/to disapprove/to take exception to
不以詞害誌	[bat1 ji5 ci4 hoi6 zi3]don't let rhetoric spoil the message (idiom); don't get carried away with flowery speech to the detriment of what you want to say
不以辭害志	[bat1 ji5 ci4 hoi6 zi3]don't let rhetoric spoil the message (idiom); don't get carried away with flowery speech to the detriment of what you want to say
不休	[bat1 jau1]endlessly/ceaselessly
不但	[bat1 daan6]not only (... but also...)
不住	[bat1 zyu6]repeatedly/continuously/constantly/unable to (resist, conceal etc)
不作為	[bat1 zok3 wai4]nonfeasance/omission (law)
不佞	[bat1 ning6]without eloquence/untalented/I, me (humble)
不佳	[bat1 gaai1]not good
不來梅	[bat1 loi4 mui4]Bremen (city)
不來梅港	[bat1 loi4 mui4 gong2]Bremerhaven, German port
不依	[bat1 ji1]not comply/not go along with/not let off easily/not let sb/get away with it
不依不饒	[bat1 ji1 bat1 jiu4]not to overlook, nor spare (idiom); unwilling to forgive/to treat severely without listening to excuses
不便	[bat1 bin6]inconvenient/inappropriate/unsuitable/short of cash
不俗	[bat1 zuk6]original/not hackneyed
不信任動議	[bat1 seon3 jam6 dung6 ji5]motion of no confidence (against the government, in parliamentary debates)
不信任投票	[bat1 seon3 jam6 tau4 piu3]vote of no-confidence
不信任案	[bat1 seon3 jam6 on3]no-confidence motion
不信用	[bat1 seon3 jung6]distrust
不修邊幅	[bat1 sau1 bin1 fuk1]not care about one's appearance (idiom)/slovenly in dress and manner
不倒翁	[bat1 dou2 jung1]roly-poly toy/tilting doll/tumbler
不倦	[bat1 gyun6]tireless/untiring/indefatigable
不倫不類	[bat1 leon4 bat1 leoi6]neither fish nor fowl/nondescript
不值	[bat1 zik6]not worth
不值一文	[bat1 zik6 jat1 man4]worthless (idiom)/no use whatsoever
不值得	[bat1 zik6 dak1]unworthy
不值錢	[bat1 zik6 cin4]of little value
不假思索	[bat1 gaa2 si1 sok3]to act without taking time to think (idiom); to react instantly/to fire from the hip
不偏不倚	[bat1 pin1 bat1 ji2]even-handed/impartial/unbiased/exact/just
不偏斜	[bat1 pin1 ce4]not leaning to one side/impartial/even-handed
不偏極	[bat1 pin1 gik6]unpolarized (light)
不做聲	[bat1 zou6 sing1]keep silent/not say a word
不停	[bat1 ting4]incessant
不備	[bat1 bei6]unprepared/off guard
不傳	[bat1 cyun4]not passed on
不傷脾胃	[bat1 soeng1 pei4 wai6]lit. doesn't hurt the spleen or the stomach/fig. something that is not critical
不僅	[bat1 gan2]not only (this one)/not just (...) but also
不僅如此	[bat1 gan2 jyu4 ci2]not only that, but ...
不像樣	[bat1 zoeng6 joeng6]in no shape to be seen/unpresentable/beyond recognition
不像話	[bat1 zoeng6 waa6]unreasonable/shocking/outrageous
不儉則匱	[bat1 gim6 zak1 gwai6]wastage makes one destitute (idiom)
不光	[bat1 gwong1]not the only one/not only
不光彩	[bat1 gwong1 coi2]disgraceful/dishonorable
不克	[bat1 hak1]cannot/to not be able (to)/to be unable to
不免	[bat1 min5]inevitably
不免一死	[bat1 min5 jat1 sei2]mortal
不入時宜	[bat1 jap6 si4 ji4]untimely/premature/inopportune/ill-timed/out of fashion/behind the times
不公	[bat1 gung1]unjust/unfair
不公正	[bat1 gung1 zing3]injustice
不共戴天	[bat1 gung6 daai3 tin1](of enemies) cannot live under the same sky/absolutely irreconcilable
不兼容性	[bat1 gim1 jung4 sing3]incompatibility
不再	[bat1 zoi3]no more/no longer
不准	[bat1 zeon2]not to allow/to forbid/to prohibit
不准許	[bat1 zeon2 heoi2]forbidden/not allowed
不凍港	[bat1 dung3 gong2]ice-free port/open port
不凍港口	[bat1 dung3 gong2 hau2]ice-free port (refers to Vladivostok)
不凡	[bat1 faan4]out of the ordinary/out of the common run
不出所料	[bat1 ceot1 so2 liu6]as expected
不分	[bat1 fan1]not divided/irrespective/not distinguishing between
不分伯仲	[bat1 fan1 baak3 zung6]lit. unable to distinguish eldest brother from second brother (idiom); they are all equally excellent/nothing to choose between them
不分勝敗	[bat1 fan1 sing3 baai6]to not be able to distinguish who's winning
不分勝負	[bat1 fan1 sing3 fu6]unable to determine victory or defeat (idiom); evenly matched/to come out even/to tie/to draw
不分彼此	[bat1 fan1 bei2 ci2]to make no distinction between what's one's own and what's another's (idiom)/to share everything/to be on very intimate terms
不分情由	[bat1 fan1 cing4 jau4]indiscriminate
不分晝夜	[bat1 fan1 zau3 je6]day and night/round-the-clock
不分清紅皂白	[bat1 fan1 cing1 hung4 zou6 baak6]not distinguishing red-blue or black-white (idiom); not to distinguish between right and wrong
不分皂白	[bat1 fan1 zou6 baak6]not distinguishing black or white (idiom); not to distinguish between right and wrong
不分軒輊	[bat1 fan1 hin1 zi3]well-matched/equally matched
不分青紅皂白	[bat1 fan1 ceng1 hung4 zou6 baak6]not distinguishing red-blue or black-white (idiom); not to distinguish between right and wrong
不分高下	[bat1 fan1 gou1 haa6]equally matched/not much to distinguish who is stronger
不切合實際	[bat1 cit3 hap6 sat6 zai3]impractical/not conforming to reality
不切實際	[bat1 cit3 sat6 zai3]unrealistic/unpractical/impracticable
不刊之論	[bat1 hon1 zi1 leon6]indisputable statement/unalterable truth
不划算	[bat1 waak6 syun3]it isn't worth it/not cost-effective/not profitable/too expensive
不列顛	[bat1 lit6 din1]Britain/British/Great Britain
不列顛保衛戰	[bat1 lit6 din1 bou2 wai6 zin3]see 不列顛戰役|不列颠战役[Bu4 lie4 dian1 Zhan4 yi4])
不列顛哥倫比亞	[bat1 lit6 din1 go1 leon4 bei2 aa3]British Columbia, Pacific province of Canada
不列顛哥倫比亞省	[bat1 lit6 din1 go1 leon4 bei2 aa3 saang2]British Columbia, Pacific province of Canada
不列顛戰役	[bat1 lit6 din1 zin3 jik6]Battle of Britain (Jul-Oct 1940)
不列顛諸島	[bat1 lit6 din1 zyu1 dou2]British Isles
不利	[bat1 lei6]unfavorable/disadvantageous/harmful/detrimental
不到	[bat1 dou3]not to arrive/not reaching/insufficient/less than
不到長城非好漢	[bat1 dou3 coeng4 sing4 fei1 hou2 hon3]lit. until you reach the Great Wall, you're not a proper person; fig. to get over difficulties before reaching the goal
不到黃河心不死	[bat1 dou3 wong4 ho4 sam1 bat1 sei2]lit. not to stop until one reaches the Yellow River (idiom)/fig. to persevere until one reaches one's goal/to keep going while some hope is left
不力	[bat1 lik6]not to do one's best/not to exert oneself
不加	[bat1 gaa1]without/not/un-
不加修飾	[bat1 gaa1 sau1 sik1]undecorated/unvarnished/no frills
不加區別	[bat1 gaa1 keoi1 bit6]indiscriminate
不加思索	[bat1 gaa1 si1 sok3]see 不假思索[bu4 jia3 si1 suo3]
不加拘束	[bat1 gaa1 keoi1 cuk1]unrestricted
不加掩飾	[bat1 gaa1 jim2 sik1]undisguised
不加牛奶	[bat1 gaa1 ngau4 naai5]without milk/black (of tea, coffee etc)
不加理睬	[bat1 gaa1 lei5 coi2]without giving due consideration/to ignore/to overlook
不加選擇	[bat1 gaa1 syun2 zaak6]indiscriminate
不動	[bat1 dung6]motionless
不動搖	[bat1 dung6 jiu4]unmoved
不動產	[bat1 dung6 caan2]real estate/immovable property/immovables
不動聲色	[bat1 dung6 sing1 sik1]not a word or movement (idiom); remaining calm and collected/not batting an eyelid
不動點	[bat1 dung6 dim2]fixed point (of a map) (math.)
不動點定理	[bat1 dung6 dim2 ding6 lei5]fixed point theorem (math.)
不務正業	[bat1 mou6 zing3 jip6]not to engage in honest work/to ignore one's proper occupation/not to attend to one's proper duties
不勝	[bat1 sing3]cannot bear or stand/be unequal to/very/extremely
不勝其擾	[bat1 sing3 kei4 jiu2]unable to put up with (sth) any longer
不勝其煩	[bat1 sing3 kei4 faan4]to be pestered beyond endurance
不勝其苦	[bat1 sing3 kei4 fu2]unable to bear the pain (idiom)
不勝枚舉	[bat1 sing3 mui4 geoi2]too numerous to mention individually or one by one
不勞無獲	[bat1 lou4 mou4 wok6]no pain, no gain (idiom)
不勞而獲	[bat1 lou4 ji4 wok6]to reap without sowing (idiom)
不匱	[bat1 gwai6]endlessly/without ceasing
不區分大小寫	[bat1 keoi1 fan1 daai6 siu2 se2]case insensitive/not distinguishing capitals from lower case letters
不卑不亢	[bat1 bei1 bat1 kong3]neither servile nor overbearing (idiom)/neither obsequious nor supercilious
不協調	[bat1 hip3 diu6]uncoordinated/disharmony
不即不離	[bat1 zik1 bat1 lei4]to be neither too familiar nor too distant/to keep sb at arm's length
不厭	[bat1 jim3]not mind doing sth/not tire of/not object to
不厭其煩	[bat1 jim3 kei4 faan4]not to mind taking all the trouble (idiom)/to take great pains/to be very patient
不去理	[bat1 heoi3 lei5]to leave sth as it is/not to bother to remedy or repair/not to bother with/not to worry about/to ignore/not to associate with sb
不及	[bat1 kap6]to fall short of/not as good as/too late
不及格	[bat1 kap6 gaak3]to fail
不及物動詞	[bat1 kap6 mat6 dung6 ci4]intransitive verb
不受歡迎	[bat1 sau6 fun1 jing4]unwelcome
不受理	[bat1 sau6 lei5]reject a complaint/refuse to entertain (a proposal)
不受管束	[bat1 sau6 gun2 cuk1]to refuse to accept discipline/out of control
不受約束	[bat1 sau6 joek3 cuk1]unrestricted
不只	[bat1 zi2]not only/not merely
不可	[bat1 ho2]cannot/should not/must not
不可一世	[bat1 ho2 jat1 sai3]to consider oneself unexcelled in the world/to be insufferably arrogant
不可以	[bat1 ho2 ji5]may not
不可估量	[bat1 ho2 gu2 loeng4]inestimable/incalculable/beyond measure
不可侵犯	[bat1 ho2 cam1 faan6]inviolable/inviolability
不可侵犯權	[bat1 ho2 cam1 faan6 kyun4]inviolability
不可再生資源	[bat1 ho2 zoi3 saang1 zi1 jyun4]nonrenewable resource
不可分割	[bat1 ho2 fan1 got3]inalienable/unalienable/inseparable/indivisible
不可分離	[bat1 ho2 fan1 lei4]inseparable
不可勝數	[bat1 ho2 sing3 sou3]countless/innumerable
不可勝言	[bat1 ho2 sing3 jin4]inexpressible (idiom)/beyond description
不可同日而語	[bat1 ho2 tung4 jat6 ji4 jyu5]lit. mustn't speak of two things on the same day (idiom); not to be mentioned in the same breath/incomparable
不可名狀	[bat1 ho2 ming4 zong6]indescribable/beyond description
不可告人	[bat1 ho2 gou3 jan4]hidden/kept secret/not to be divulged
不可多得	[bat1 ho2 do1 dak1]hard to come by/rare
不可導	[bat1 ho2 dou6]not differentiable (function in calculus)
不可思議	[bat1 ho2 si1 ji5]inconceivable (idiom); unimaginable/unfathomable
不可或缺	[bat1 ho2 waak6 kyut3]necessary/must have
不可抗力	[bat1 ho2 kong3 lik6]unpredictable eventuality/unpreventable/unavoidable/impossible to overcome/nothing can be done about it/act of God/force majeure
不可抗拒	[bat1 ho2 kong3 keoi5]act of God/force majeure (law)/irresistible (idiom)
不可挽回	[bat1 ho2 waan5 wui4]irreversible
不可撤銷信用證	[bat1 ho2 cit3 siu1 seon3 jung6 zing3]irrevocable letter of credit
不可收拾	[bat1 ho2 sau1 sap6]irremediable/unmanageable/out of hand/hopeless
不可救藥	[bat1 ho2 gau3 joek6]incurable/incorrigible/beyond cure/hopeless
不可數	[bat1 ho2 sou3]uncountable
不可數名詞	[bat1 ho2 sou3 ming4 ci4]uncountable noun (in grammar of European languages)
不可數集	[bat1 ho2 sou3 zaap6]uncountable set (math.)
不可枚舉	[bat1 ho2 mui4 geoi2]innumerable (idiom)
不可理喻	[bat1 ho2 lei5 jyu6]to be impervious to reason (idiom)/unreasonable
不可知論	[bat1 ho2 zi1 leon6]agnosticism, the philosophical doctrine that some questions about the universe are in principle unanswerable
不可磨滅	[bat1 ho2 mo4 mit6]indelible
不可端倪	[bat1 ho2 dyun1 ngai4]impossible to get even an outline (idiom)/unfathomable/not a clue
不可終日	[bat1 ho2 zung1 jat6]to be unable to carry on even for a single day/to be in a desperate situation
不可缺少	[bat1 ho2 kyut3 siu2]indispensable
不可置信	[bat1 ho2 zi3 seon3]unbelievable/incredible
不可能	[bat1 ho2 nang4]impossible/cannot/not able
不可解	[bat1 ho2 gaai2]insoluble (i.e. impossible to solve)
不可言喻	[bat1 ho2 jin4 jyu6]inexpressible (idiom)
不可逆	[bat1 ho2 jik6]irreversible
不可逆轉	[bat1 ho2 jik6 zyun2]irreversible
不可通約	[bat1 ho2 tung1 joek3]having no common measure/incommensurable/incommensurate
不可逾越	[bat1 ho2 jyu4 jyut6]impassable/insurmountable/insuperable
不可避	[bat1 ho2 bei6]unavoidable
不可避免	[bat1 ho2 bei6 min5]unavoidably
不可開交	[bat1 ho2 hoi1 gaau1]to be awfully (busy etc)
不可靠	[bat1 ho2 kaau3]unreliable
不合	[bat1 hap6]to not conform to/to be unsuited to/to be out of keeping with/should not/ought out
不合作	[bat1 hap6 zok3]noncooperation
不合時宜	[bat1 hap6 si4 ji4]untimely/premature/inopportune/ill-timed/out of fashion/behind the times
不合法	[bat1 hap6 faat3]illegal
不合理	[bat1 hap6 lei5]unreasonable
不合適	[bat1 hap6 sik1]improper/unsuitable/inappropriate
不合體統	[bat1 hap6 tai2 tung2]not according with decorum/scandalous/bad form/unacceptable behavior
不吉	[bat1 gat1]unlucky/inauspicious/ominous
不吉利	[bat1 gat1 lei6]ominous
不同	[bat1 tung4]different/distinct/not the same/not alike
不同凡響	[bat1 tung4 faan4 hoeng2]lit. not a common chord (idiom); outstanding/brilliant/out of the common run
不名一文	[bat1 ming4 jat1 man4]without a penny to one's name/penniless/stony-broke
不名數	[bat1 ming4 sou3]abstract number
不名譽	[bat1 ming4 jyu6]disreputable/disgraceful
不名譽事物	[bat1 ming4 jyu6 si6 mat6]dishonor
不吐不快	[bat1 tou3 bat1 faai3]to have to pour out what's on one's mind (idiom)
不吐氣	[bat1 tou3 hei3]unaspirated
不吝	[bat1 leon6]not to stint/to be generous (with praise etc)/to be prepared to (pay a fee, give of one's time etc)
不吝珠玉	[bat1 leon6 zyu1 juk6]lit. do not begrudge gems of wisdom (idiom, humble expr.); fig. Please give me your frank opinion./Your criticism will be most valuable.
不含糊	[bat1 ham4 wu4]unambiguous/unequivocal/explicit/prudent/cautious/not negligent/unafraid/unhesitating/really good/extraordinary
不周	[bat1 zau1]not satisfactory/thoughtless/inconsiderate
不周山	[bat1 zau1 saan1]Buzhou Mountain, a mountain from Chinese legend
不周延	[bat1 zau1 jin4]undistributed
不咋地	[bat1 zaa3 dei6](dialect) not that great/not up to much/nothing special
不和	[bat1 wo4]not to get along well/to be on bad terms/to be at odds/discord
不咎既往	[bat1 gau3 gei3 wong5]not censure sb for his past misdeeds/overlook sb's past mistakes/let bygones be bygones
不問	[bat1 man6]to pay no attention to/to disregard/to ignore/to let go unpunished/to let off
不問就聽不到假話	[bat1 man6 zau6 ting1 bat1 dou3 gaa2 waa6]Don't ask and you won't be told any lies. (idiom)
不問青紅皂白	[bat1 man6 ceng1 hung4 zou6 baak6]not distinguishing red-blue or black-white (idiom); not to distinguish between right and wrong
不啻	[bat1 ci3]just as/no less than/like (sth momentous)/as good as/tantamount to
不啻天淵	[bat1 ci3 tin1 jyun1]no less than from heaven to the abyss (idiom); differing widely/worlds apart/the gap couldn't be bigger
不善	[bat1 sin6]bad/ill/not good at/not to be pooh-poohed/quite impressive
不單	[bat1 daan1]not the only/not merely/not simply
不圓通	[bat1 jyun4 tung1]inflexible/unaccommodating
不在	[bat1 zoi6]not to be present/to be out/(euphemism) to pass away/to be deceased
不在乎	[bat1 zoi6 fu4]not to care
不在了	[bat1 zoi6 liu5]to be dead/to have passed away
不在其位不謀其政	[bat1 zoi6 kei4 wai6 bat1 mau4 kei4 zing3]don't meddle in affairs that are not part of your position (Confucius)
不在意	[bat1 zoi6 ji3]to pay no attention to/not to mind
不在狀態	[bat1 zoi6 zong6 taai3]to be out of form/not to be oneself
不在話下	[bat1 zoi6 waa6 haa6]to be nothing difficult/to be a cinch
不均	[bat1 gwan1]uneven/distributed unevenly
不均勻	[bat1 gwan1 wan4]inhomogeneous
不堪	[bat1 ham1]cannot bear/cannot stand/utterly/extremely
不堪一擊	[bat1 ham1 jat1 gik1]to be unable to withstand a single blow/to collapse at the first blow
不堪入目	[bat1 ham1 jap6 muk6]unbearable to look at/an eyesore
不堪忍受	[bat1 ham1 jan2 sau6]unbearable
不外	[bat1 ngoi6]not beyond the scope of/nothing more than
不外乎	[bat1 ngoi6 fu4]nothing else but
不外露	[bat1 ngoi6 lou6]not exposed/concealed from view
不夠	[bat1 gau3]not enough/insufficient/inadequate
不大	[bat1 daai6]not very/not too/not often
不大離	[bat1 daai6 lei4]pretty close/just about right/not bad/same as 差不多
不大離兒	[bat1 daai6 lei4 ji4]erhua variant of 不大離|不大离[bu4 da4 li2]
不太好	[bat1 taai3 hou2]not so good/not too well
不失時機	[bat1 sat1 si4 gei1]to seize the opportune moment/to lose no time
不失為	[bat1 sat1 wai4]can still be considered (to be...)/may after all be accepted as
不好	[bat1 hou2]no good
不好受	[bat1 hou2 sau6]unpleasant/hard to take
不好惹	[bat1 hou2 je5]not to be trifled with/not to be pushed around/stand no nonsense
不好意思	[bat1 hou2 ji3 si1]to feel embarrassed/to find it embarrassing/to be sorry (for inconveniencing sb)
不好說	[bat1 hou2 syut3]hard to say/unpleasant to say/can't be sure
不如	[bat1 jyu4]not equal to/not as good as/inferior to/it would be better to
不如人意	[bat1 jyu4 jan4 ji3]leaving much to be desired/unsatisfactory/undesirable
不妙	[bat1 miu6](of a turn of events) not too encouraging/far from good/anything but reassuring
不妥	[bat1 to5]not proper/inappropriate
不妥協	[bat1 to5 hip3]uncompromising
不妨	[bat1 fong4]there is no harm in/might as well
不孕	[bat1 jan6]infertility
不孕症	[bat1 jan6 zing3]female infertility
不孚眾望	[bat1 fu1 zung3 mong6]not living up to expectations (idiom)/failing to inspire confidence among people/unpopular
不孝	[bat1 haau3]unfilial
不學無術	[bat1 hok6 mou4 seot6]without learning or skills (idiom); ignorant and incompetent
不安	[bat1 on1]unpeaceful/unstable/uneasy/disturbed/restless/worried
不安其室	[bat1 on1 kei4 sat1]to be discontented with one's home/to have adulterous relations after marriage (of women) (idiom)
不安分	[bat1 on1 fan1]restless/unsettled
不安好心	[bat1 on1 hou2 sam1]to have bad intentions
不完全中立	[bat1 jyun4 cyun4 zung1 laap6]imperfect neutrality
不完全歸納推理	[bat1 jyun4 cyun4 gwai1 naap6 teoi1 lei5]inference by incomplete induction
不完全葉	[bat1 jyun4 cyun4 jip6]incomplete leaf
不完善	[bat1 jyun4 sin6]imperfect
不完美	[bat1 jyun4 mei5]defective/imperfect
不定	[bat1 ding6]indefinite/indeterminate/(botany) adventitious
不定元	[bat1 ding6 jyun4]indeterminate element (math.), often denoted by x
不定冠詞	[bat1 ding6 gun3 ci4]indefinite article (e.g. English a, an)
不定式	[bat1 ding6 sik1]infinitive (grammar)
不定形	[bat1 ding6 jing4]indeterminate form
不定方程	[bat1 ding6 fong1 cing4](math.) indeterminate equation
不定期	[bat1 ding6 kei4]non-scheduled/irregularly
不定積分	[bat1 ding6 zik1 fan1]indefinite integral (math.)
不定詞	[bat1 ding6 ci4]infinitive
不宜	[bat1 ji4]not suitable/inadvisable/inappropriate
不客氣	[bat1 haak3 hei3]you're welcome/don't mention it/impolite/rude/blunt
不宣而戰	[bat1 syun1 ji4 zin3]open hostilities without declaring war/start an undeclared war
不容	[bat1 jung4]must not/cannot/to not allow/cannot tolerate
不容置疑	[bat1 jung4 zi3 ji4]unquestionable
不容置辯	[bat1 jung4 zi3 bin6]peremptory/not to be denied/not brooking argument
不寒而慄	[bat1 hon4 ji4 leot6]shiver all over though not cold/tremble with fear/shudder
不對	[bat1 deoi3]incorrect/wrong/amiss/abnormal/queer
不對勁	[bat1 deoi3 ging6]not in good condition/wrong/fishy
不對勁兒	[bat1 deoi3 ging6 ji4]erhua variant of 不對勁|不对劲[bu4 dui4 jin4]
不對盤	[bat1 deoi3 pun4](of a person) objectionable/(of two people) to find each other disagreeable
不對稱	[bat1 deoi3 cing1]unsymmetrical/asymmetric
不對頭	[bat1 deoi3 tau4]fishy/not right/amiss
不少	[bat1 siu2]many/a lot/not few
不局限	[bat1 guk6 haan6]not confined
不屈	[bat1 wat1]unyielding/unbending
不屈不撓	[bat1 wat1 bat1 naau4]unyielding/indomitable
不屑	[bat1 sit3]to disdain to do sth/to think sth not worth doing/to feel it beneath one's dignity
不屑一顧	[bat1 sit3 jat1 gu3]to disdain as beneath contempt (idiom)
不巧	[bat1 haau2]too bad/unfortunately/as luck would have it
不差	[bat1 caa1]to not lack
不差	[bat1 caa1]not bad/OK
不已	[bat1 ji5]endlessly/incessantly
不帶	[bat1 daai3]not to have/without/un-
不帶電	[bat1 daai3 din6]uncharged/electrically neutral
不干涉	[bat1 gon1 sip3]noninterference/nonintervention
不平	[bat1 ping4]uneven/injustice/unfairness/wrong/grievance/indignant/dissatisfied
不平凡	[bat1 ping4 faan4]marvelous/marvelously
不平則鳴	[bat1 ping4 zak1 ming4]where there is injustice, there will be an outcry/man will cry out against injustice
不平常	[bat1 ping4 soeng4]remarkable/remarkably/unusual
不平等	[bat1 ping4 dang2]inequality/unfairness
不平等條約	[bat1 ping4 dang2 tiu4 joek3]unequal treaty
不平衡	[bat1 ping4 hang4]disequilibrium
不幸	[bat1 hang6]misfortune/adversity/unfortunate/sad/unfortunately
不幸之事	[bat1 hang6 zi1 si6]mishap
不幸受害	[bat1 hang6 sau6 hoi6]the unfortunate injured (party)/a victim
不待說	[bat1 doi6 syut3]needless to say/it goes without saying
不很	[bat1 han2]not very
不得	[bat1 dak1]must not/may not/not to be allowed/cannot
不得不	[bat1 dak1 bat1]have no choice or option but to/cannot but/have to/can't help it/can't avoid
不得人心	[bat1 dak1 jan4 sam1]not to enjoy popular support/to be unpopular
不得其門而入	[bat1 dak1 kei4 mun4 ji4 jap6]to be unable to get in/to fail to find a proper approach to handling sth
不得勁	[bat1 dak1 ging6]awkward/unhandy/be indisposed/not feel well
不得已	[bat1 dak1 ji5]to act against one's will/to have no alternative but to/to have to/to have no choice/must
不得已而為之	[bat1 dak1 ji5 ji4 wai4 zi1]to have no other choice/to be the last resort
不得而知	[bat1 dak1 ji4 zi1]unknown/unable to find out
不得要領	[bat1 dak1 jiu3 ling5]fail to grasp the main points
不復	[bat1 fuk6]no longer/no more
不必	[bat1 bit1]need not/does not have to/not necessarily
不必要	[bat1 bit1 jiu3]needless/unnecessary
不忍	[bat1 jan2]cannot bear to/disturbed
不忙	[bat1 mong4]there's no hurry/take one's time
不快	[bat1 faai3]unhappy/in low spirits/(of a knife) not sharp
不念舊惡	[bat1 nim6 gau6 ok3]do not recall old grievances (idiom, from Analects); forgive and forget
不忿	[bat1 fan6]unsatisfied/unconvinced/indignant
不怎麼	[bat1 zam2 mo1]not very/not particularly
不怎麼樣	[bat1 zam2 mo1 joeng6]not up to much/very indifferent/nothing great about it/nothing good to be said about it
不怕	[bat1 paa3]fearless/not worried (by setbacks or difficulties)/even if/even though
不怠	[bat1 toi5]untiring/indefatigable
不急之務	[bat1 gap1 zi1 mou6]a matter of no great urgency
不恤	[bat1 seot1]not to worry/not to show concern
不恤人言	[bat1 seot1 jan4 jin4]not to worry about the gossip (idiom); to do the right thing regardless of what others say
不恥下問	[bat1 ci2 haa6 man6]not feel ashamed to ask and learn from one's subordinates
不恭	[bat1 gung1]disrespectful
不息	[bat1 sik1]continually/without a break/ceaselessly
不悅	[bat1 jyut6]displeased/annoyed
不患寡而患不均	[bat1 waan6 gwaa2 ji4 waan6 bat1 gwan1]do not worry about scarcity, but rather about uneven distribution (idiom, from Analects)
不情之請	[bat1 cing4 zi1 cing2]my presumptuous request (humble expr.); if I may be so bold to ask a favor
不情願	[bat1 cing4 jyun6]unwilling
不惑	[bat1 waak6]without doubt/with full self-confidence/forty years of age
不惜	[bat1 sik1]not stint/not spare/not hesitate (to do sth)/not scruple (to do sth)
不惜血本	[bat1 sik1 hyut3 bun2]to spare no effort/to devote all one's energies
不惟	[bat1 wai4]not only
不想	[bat1 soeng2]unexpectedly
不愉快	[bat1 jyu4 faai3]disagreeable/unpleasant
不意	[bat1 ji3]unexpectedly/unawareness/unpreparedness
不愧	[bat1 kwai5]to be worthy of/to deserve to be called/to prove oneself to be
不愧下學	[bat1 kwai5 haa6 hok6]not ashamed to learn from subordinates (idiom)
不愧不怍	[bat1 kwai5 bat1 zok6]no shame, no subterfuge (idiom); just and honorable/upright and above board
不慌不忙	[bat1 fong1 bat1 mong4]calm and unhurried (idiom); composed/to take matters calmly
不慎	[bat1 san6]incautious/inattentive
不憤不啟	[bat1 fan5 bat1 kai2]the heart desperately wants to understand how to do sth but cannot (idiom)
不懂裝懂	[bat1 dung2 zong1 dung2]to pretend to understand when you don't
不懈	[bat1 haai6]untiring/unremitting/indefatigable
不懈怠	[bat1 haai6 toi5]untiring/without slacking
不應期	[bat1 jing1 kei4]refractory period (physiology)
不懷好意	[bat1 waai4 hou2 ji3]to harbor evil designs/to harbor malicious intentions
不成	[bat1 sing4]won't do/unable to/(at the end of a rhetorical question) can that be?
不成文	[bat1 sing4 man4]unwritten (rule)
不成文法	[bat1 sing4 man4 faat3]unwritten law
不成材	[bat1 sing4 coi4]worthless/good-for-nothing
不成樣子	[bat1 sing4 joeng6 zi2]shapeless/deformed/ruined/beyond recognition/(of a person) reduced to a shadow
不成熟	[bat1 sing4 suk6]unripe/immature
不成話	[bat1 sing4 waa6]see 不像話|不像话[bu4 xiang4 hua4]
不成體統	[bat1 sing4 tai2 tung2]not according with decorum (idiom); scandalous/bad form/unacceptable behavior
不戰不和	[bat1 zin3 bat1 wo4]neither war nor peace
不才	[bat1 coi4]untalented/I/me (humble)
不打不成器	[bat1 daa2 bat1 sing4 hei3]spare the rod and spoil the child (idiom)
不打不成才	[bat1 daa2 bat1 sing4 coi4]spare the rod and spoil the child (idiom)
不打不成相識	[bat1 daa2 bat1 sing4 soeng1 sik1]don't fight, won't make friends (idiom); an exchange of blows may lead to friendship
不打緊	[bat1 daa2 gan2]unimportant/not serious/it doesn't matter/never mind
不打自招	[bat1 daa2 zi6 ziu1]to confess without being pressed/to make a confession without duress
不承認主義	[bat1 sing4 jing6 zyu2 ji6]policy of non-recognition
不折不扣	[bat1 zit3, bat1 kau3]a hundred percent/to the letter/out-and-out
不抵抗主義	[bat1 dai2 kong3 zyu2 ji6]policy of nonresistance
不拉嘰	[bat1 laai1 gi1](nasty, stupid etc) as can be
不拉幾	[bat1 laai1 gei2](dialect) extremely
不拘	[bat1 keoi1]not stick to/not confine oneself to/whatever
不拘一格	[bat1 keoi1 jat1 gaak3]not stick to one pattern
不拘小節	[bat1 keoi1 siu2 zit3]to not bother about trifles (idiom)
不振	[bat1 zan3]lacking in vitality/depressed (market, spirits etc)
不捨	[bat1 se2]reluctant to part with (sth or sb)/unwilling to let go of
不提也罷	[bat1 tai4 jaa5 baa6]best not to mention it/drop it/never mind/let's not talk about it
不插電	[bat1 caap3 din6]unplugged (of rock musicians performing on acoustic instruments)
不揣冒昧	[bat1 cyun2 mou6 mui6]to venture to/to presume to/to take the liberty of
不搭理	[bat1 daap3 lei5]variant of 不答理[bu4 da1 li3]
不摸頭	[bat1 mo2 tau4]not acquainted with the situation/not up on things
不撞南牆不回頭	[bat1 zong6 naam4 coeng4 bat1 wui4 tau4]to stubbornly insist on one's own ideas (idiom)
不擇手段	[bat1 zaak6 sau2 dyun6]by fair means or foul/by hook or by crook/unscrupulously
不擴散核武器條約	[bat1 kong3 saan3 hat6 mou5 hei3 tiu4 joek3]Treaty on the Non-Proliferation of Nuclear Weapons
不支	[bat1 zi1]to be unable to endure
不攻自破	[bat1 gung1 zi6 po3](of a rumor etc) to collapse (in the light of facts etc)/to be discredited
不敗之地	[bat1 baai6 zi1 dei6]invincible position
不敢當	[bat1 gam2 dong1]lit. I dare not (accept the honor); fig. I don't deserve your praise/you flatter me
不敢自專	[bat1 gam2 zi6 zyun1]not daring to act for oneself (idiom)
不敢苟同	[bat1 gam2 gau2 tung4]to beg to differ (idiom)
不敢越雷池一步	[bat1 gam2 jyut6 leoi4 ci4 jat1 bou6]dare not go one step beyond the prescribed limit
不敢高攀	[bat1 gam2 gou1 paan1]lit. not dare to pull oneself up high (humble term)/I cannot presume on your attention
不敬	[bat1 ging3]disrespect/irreverent/rude/insufficiently respectful (to a superior)
不敵	[bat1 dik6]no match for/cannot beat
不料	[bat1 liu6]unexpectedly/to one's surprise
不新鮮	[bat1 san1 sin1]stale
不斷	[bat1 tyun5]unceasing/uninterrupted/continuous/constant
不方便	[bat1 fong1 bin6]inconvenience/inconvenient
不日	[bat1 jat6]within the next few days/in a few days time
不明	[bat1 ming4]not clear/unknown/to fail to understand
不明不白	[bat1 ming4 bat1 baak6]obscure/dubious/shady
